id,release_date,movie,production_budget,domestic_gross,worldwide_gross,profit,profit_margin,domestic_profit_margin,cost_revenue_ratio_in_%
93,2009-09-25,Paranormal Activity,450000,107918810,194183034,193733034,0.9976825987794588,0.9958301986465566,23981.957777777778
80,2015-07-10,The Gallows,100000,22764410,41656474,41556474,0.9975994127587469,0.9956071780467844,22764.41
10,2004-05-07,Super Size Me,65000,11529368,22233808,22168808,0.997076524183352,0.9943622234974198,17737.48923076923
8,2004-06-11,Napoleon Dynamite,400000,44540956,46122713,45722713,0.9913274832727208,0.9910195012428561,11135.239
81,2006-09-29,Facing the Giants,100000,10178331,10243159,10143159,0.9902373867280592,0.9901752065245274,10178.331
29,2008-09-26,Fireproof,500000,33456317,33473297,32973297,0.9850627202931339,0.9850551392133211,6691.2634
57,2007-05-16,Once,150000,9445857,23323631,23173631,0.9935687543676196,0.9841200221430412,6297.238
31,2004-08-06,Open Water,500000,30500882,55518641,55018641,0.9909940158657702,0.9836070314294518,6100.1764
12,2012-01-06,The Devil Inside,1000000,53262945,101759490,100759490,0.9901729067234908,0.9812252213992299,5326.2945
90,2014-03-21,Godâs Not Dead,1150000,60755732,63777092,62627092,0.9819684472286696,0.9810717448026138,5283.107130434782
48,2002-04-19,My Big Fat Greek Wedding,5000000,241438208,374890034,369890034,0.986662755617558,0.9792907674331314,4828.76416
17,2001-03-16,Gabriela,50000,2335352,2335352,2285352,0.9785899513221132,0.9785899513221133,4670.704
57,2004-10-29,Saw,1200000,55968727,103880027,102680027,0.9884482124749546,0.9785594551757448,4664.060583333333
63,2011-04-01,Insidious,1500000,54009150,99870886,98370886,0.9849806078620351,0.9722269282149414,3600.6100000000006
49,2017-02-24,Get Out,5000000,176040665,255367951,250367951,0.980420409137402,0.9715974715273883,3520.8133
14,2015-04-17,Unfriended,1000000,32789645,64364198,63364198,0.984463412408246,0.9695025670451753,3278.9645
65,2010-10-20,Paranormal Activity 2,3000000,84752907,177512032,174512032,0.9830997371490853,0.964602984060476,2825.0969
50,2017-01-20,Split,5000000,138141585,278964806,273964806,0.9820765921275388,0.9638052509676938,2762.8316999999997
41,2003-11-14,Tupac Resurrection,300000,7718961,7808524,7508524,0.9615804472138396,0.9611346656629046,2572.9869999999996
16,2006-05-24,An Inconvenient Truth,1000000,24146161,53365925,52365925,0.9812614510101717,0.9585855490651288,2414.6160999999997
15,2010-08-27,The Last Exorcism,1800000,41034350,70165900,68365900,0.9743465130497863,0.9561343118631098,2279.686111111111
35,2005-06-24,La marche de l'empereur,3400000,77437223,133276359,129876359,0.9744890990006713,0.9560934668331276,2277.565382352941
66,2015-08-28,War Room,3000000,67790117,73975239,70975239,0.9594458897253445,0.9557457615835063,2259.6705666666667
67,2013-06-07,The Purge,3000000,64473115,91266581,88266581,0.9671292605997808,0.9534689769526414,2149.103833333333
39,2001-11-23,In the Bedroom,1700000,35930604,42137871,40437871,0.959656243667365,0.9526865732621694,2113.5649411764707
51,2011-10-21,Paranormal Activity 3,5000000,104028807,207039844,202039844,0.9758500590833133,0.9519363900808744,2080.57614
86,2007-12-05,Juno,7000000,143495265,231450102,224450102,0.9697559001291777,0.9512179025558788,2049.932357142857
15,2004-06-23,Fahrenheit 9/11,6000000,119114517,221148959,215148959,0.9728689656639984,0.9496283060107611,1985.24195
58,2002-07-19,Tadpole,150000,2891288,3270128,3120128,0.9541302358806749,0.9481200074153803,1927.5253333333333
64,2016-10-21,Moonlight,1500000,27854931,65245512,63745512,0.9770099129576912,0.9461495704297382,1856.9954
17,2013-08-23,You're Next,1000000,18494006,26887177,25887177,0.962807549487252,0.9459284267562149,1849.4006
18,2012-05-25,Chernobyl Diaries,1000000,18119640,42411721,41411721,0.9764216123179723,0.9448112655659825,1811.964
38,2013-07-12,Fruitvale Station,900000,16098998,17549645,16649645,0.948716911367723,0.9440958996330082,1788.7775555555556
52,2005-10-28,Saw II,5000000,87025093,152925093,147925093,0.9673042539853155,0.942545307018517,1740.5018599999999
87,2011-09-30,Courageous,2000000,34522221,35185884,33185884,0.9431590236584648,0.9420662998478574,1726.11105
71,2002-06-28,Lovely and Amazing,250000,4210379,4613482,4363482,0.9458109948190976,0.9406229225445025,1684.1516
53,2013-09-13,Insidious Chapter 2,5000000,83586447,161921515,156921515,0.9691208422796688,0.9401816899813914,1671.72894
88,2012-06-29,Magic Mike,7000000,113721571,170549753,163549753,0.9589562583535376,0.9384461545998164,1624.5938714285714
33,2005-05-13,Mad Hot Ballroom,500000,8117961,9387581,8887581,0.9467381426589021,0.938408179098175,1623.5921999999998
69,2012-10-12,Sinister,3000000,48086903,87727807,84727807,0.9658033170714047,0.9376129504534738,1602.8967666666667
12,2013-01-11,A Haunted House,2500000,40041683,59922558,57422558,0.9582794846641894,0.9375650618881329,1601.66732
86,2017-07-07,A Ghost Story,100000,1594798,2769782,2669782,0.9638960755756231,0.9372961340558491,1594.798
36,2018-10-19,Halloween,10000000,159342015,254900667,244900667,0.9607690316479243,0.9372419132518187,1593.42015
72,2017-04-28,Sleight,250000,3930990,3934450,3684450,0.9364587172285834,0.9364027891192804,1572.396
59,2002-02-15,Super Troopers,1200000,18492362,23046142,21846142,0.9479305473341264,0.9351083436502055,1541.0301666666667
73,2003-04-11,Better Luck Tomorrow,250000,3802390,3809226,3559226,0.9343698693645377,0.9342518784238334,1520.956
60,2004-02-25,The Passion of the Christ,25000000,370782930,622341924,597341924,0.9598291565522107,0.9325751053318447,1483.13172
94,2005-12-25,Wolf Creek,1100000,16186348,29005064,27905064,0.9620755879042363,0.9320414957098414,1471.4861818181819
22,2016-03-11,"Hello, My Name is Doris",1000000,14444999,14662703,13662703,0.9317997507008087,0.9307718885961848,1444.4999
54,2016-03-11,10 Cloverfield Lane,5000000,72082999,108286422,103286422,0.953826159294468,0.9306355164273895,1441.65998
91,2005-10-07,Waiting...,1125000,16124543,18673274,17548274,0.9397534679778169,0.930230580798476,1433.2927111111112
65,2003-09-12,Cabin Fever,1500000,21158188,30351664,28851664,0.9505793158490421,0.9291054602596404,1410.5458666666668
74,2011-10-28,Like Crazy,250000,3395391,3728400,3478400,0.9329471086793263,0.9263707773272651,1358.1564
55,2016-07-22,Lights Out,5000000,67268835,148806510,143806510,0.9663993194921379,0.9256713751620643,1345.3766999999998
13,2012-07-13,2016: Obamaâs America,2500000,33349941,33349941,30849941,0.9250373486417862,0.9250373486417862,1333.99764
73,2012-06-15,Your Sister's Sister,120000,1597486,3090593,2970593,0.961172499905358,0.9248819707966142,1331.2383333333332
56,2015-09-11,The Visit,5000000,65206105,98677816,93677816,0.9493300500286711,0.923320063359098,1304.1221
84,2014-10-03,Annabelle,6500000,84273813,256862920,250362920,0.9746946737193519,0.922870465111149,1296.5202
14,2013-07-03,Kevin Hart: Let Me Explain,2500000,32244051,32327255,29827255,0.9226658743527714,0.9224663178953538,1289.7620399999998
57,2002-10-25,Jackass: The Movie,5000000,64282312,79282312,74282312,0.9369342306768249,0.9222181056586763,1285.64624
66,2007-05-02,Waitress,1500000,19097550,22217183,20717183,0.932484689890703,0.921455893557027,1273.17
18,2011-02-25,The Grace Card,200000,2430735,2430735,2230735,0.9177203603025423,0.9177203603025422,1215.3675
90,2018-03-16,I Can Only Imagine,7000000,83482352,85604221,78604221,0.9182283312875424,0.9161499426848922,1192.6050285714286
91,2018-04-13,Truth or Dare,3500000,41411015,95127344,91627344,0.9632072141108028,0.9154814244470946,1183.171857142857
34,2003-10-03,The Station Agent,500000,5801558,9470209,8970209,0.9472028547627618,0.9138162541855136,1160.3116
60,2002-02-22,Monsoon Wedding,1200000,13876974,27025600,25825600,0.9555976555562133,0.9135258162190114,1156.4145
79,2003-09-12,Lost in Translation,4000000,44585453,117085297,113085297,0.9658368719003206,0.9102846392521794,1114.636325
58,2017-10-13,Happy Death Day,5000000,55683845,125010260,120010260,0.9600032829305369,0.91020735008511,1113.6769
66,2018-04-06,A Quiet Place,17000000,188024361,334522294,317522294,0.9491812644331561,0.9095861838881611,1106.0256529411765
38,2004-10-22,The Grudge,10000000,110359362,187281115,177281115,0.9466043332772768,0.9093869353829719,1103.59362
59,2012-10-19,Paranormal Activity 4,5000000,53900335,142817992,137817992,0.9649904054105451,0.9072361980681567,1078.0067000000001
15,2004-07-28,Garden State,2500000,26782316,36028802,33528802,0.9306110705540527,0.9066548240264211,1071.2926400000001
43,2014-06-06,The Fault in Our Stars,12000000,124872350,307166834,295166834,0.9609332822696607,0.9039018645841133,1040.6029166666667
75,2011-09-09,Kevin Hart: Laugh at My Pain,750000,7706436,7712436,6962436,0.9027544604584078,0.9026787479971287,1027.5248
60,2014-10-24,Ouija,5000000,50856010,103300632,98300632,0.9515975855791473,0.9016832032241617,1017.1202
39,2016-04-01,Meet the Blacks,900000,9097072,9097072,8197072,0.901067068612846,0.901067068612846,1010.7857777777778
74,2008-11-12,Slumdog Millionaire,14000000,141330703,384530440,370530440,0.9635919590657114,0.900941552664604,1009.5050214285715
23,2005-09-16,Cry Wolf,1000000,10047674,15943081,14943081,0.9372768663723153,0.9004744779737082,1004.7674000000001
85,2008-02-01,Hannah Montana/Miley Cyrus: Best of Both Worlds Concert Tour,6500000,65281781,70712099,64212099,0.9080779655543815,0.9004316380400222,1004.3350923076923
7,2006-01-06,Hostel,4800000,47326473,82241110,77441110,0.9416350290019188,0.8985768493671608,985.9681875
25,2010-12-29,Blue Valentine,1000000,9737892,16566240,15566240,0.9396362723225065,0.8973083702304359,973.7892
24,2017-09-08,It,35000000,327481748,697457969,662457969,0.9498177645741404,0.8931238146438623,935.6621371428572
97,2010-11-26,The Kingâs Speech,15000000,138797449,430821168,415821168,0.9651827692923389,0.891928849499244,925.3163266666667
16,2005-02-25,Diary of a Mad Black Woman,5500000,50406346,50458356,44958356,0.8909992232010095,0.8908867546161747,916.4790181818182
26,2006-01-20,Transamerica,1000000,9015303,16553163,15553163,0.9395885849731559,0.8890774941230484,901.5302999999999
81,2015-01-23,The Boy Next Door,4000000,36006065,53401938,49401938,0.9250963513721169,0.8889076048715682,900.151625
69,2003-10-17,The Texas Chainsaw Massacre,9000000,80571655,107967319,98967319,0.9166414422127125,0.8882981862542106,895.2406111111111
39,2016-08-26,Donât Breathe,10000000,89217875,158973685,148973685,0.9370965075131774,0.8879148376936796,892.17875
62,2013-08-30,No se Aceptan Devoluciones,5000000,44467206,100486616,95486616,0.9502421297578575,0.8875575856958496,889.34412
59,2011-12-30,Jodaeiye Nader az Simin,800000,7098492,24426169,23626169,0.9672482410156091,0.8873000068183496,887.3115
29,2018-07-20,Unfriended: Dark Web,1000000,8866745,16434588,15434588,0.9391527186443615,0.8872190414859117,886.6745
63,2015-08-07,The Gift,5000000,43787265,58978477,53978477,0.9152233110393815,0.8858115481750231,875.7453
88,2019-03-22,Us,20000000,175006930,254210310,234210310,0.9213249848127719,0.8857188112493602,875.0346499999999
64,2017-06-23,The Big Sick,5000000,42872467,53972860,48972860,0.907360847655655,0.8833750341448744,857.44934
68,2010-12-10,The Fighter,11000000,93617009,129262388,118262388,0.9149017732830373,0.8824999845914753,851.0637181818181
43,2003-10-17,Pieces of April,300000,2528664,3571253,3271253,0.9159958703569867,0.8813602756238077,842.8879999999999
64,2014-05-09,Neighbors,18000000,150086800,270944428,252944428,0.9335657125969757,0.8800693998406256,833.8155555555555
69,2008-10-24,High School Musical 3: Senior Year,11000000,90559416,274392880,263392880,0.959911496245821,0.8785327855912852,823.2674181818181
46,2010-12-03,Black Swan,13000000,106954678,331266710,318266710,0.9607566966206775,0.8784531893032299,822.7282923076922
41,2006-10-27,Saw III,10000000,80238724,163876815,153876815,0.9389785553252301,0.8753718964922722,802.38724
71,2014-07-18,The Purge: Anarchy,9000000,71562550,111534881,102534881,0.9193077544952059,0.8742358957303785,795.1394444444444
86,2005-07-22,Hustle & Flow,2800000,22202809,23591783,20791783,0.8813146085651942,0.8738898307867261,792.9574642857143
25,2009-06-05,The Hangover,35000000,277322503,465764086,430764086,0.9248546612930564,0.873793148333152,792.3500085714286
42,2016-07-01,The Purge: Election Year,10000000,79042440,118514727,108514727,0.9156223006782948,0.8734856869297051,790.4244
84,2001-12-26,Monster's Ball,4000000,31273922,43766463,39766463,0.9086058199402588,0.8720979095618387,781.84805
19,2018-05-11,Breaking In,6000000,46840590,51411620,45411620,0.8832948660244512,0.8719059687335279,780.6765
45,2012-04-20,Think Like a Man,12000000,91547205,113373764,101373764,0.8941554061837445,0.8689200833602729,762.893375
46,2014-04-16,Heaven is for Real,12000000,91386097,100916299,88916299,0.8810895750348513,0.8686889976272868,761.5508083333333
79,2005-05-06,Crash,7303082,55334418,101173038,93869956,0.927815926610803,0.8680191775035928,757.6858372944463
92,2016-12-09,La La Land,20000000,151101803,426351163,406351163,0.9530903120815458,0.8676389056720918,755.509015
35,2010-01-22,To Save a Life,500000,3777210,3824868,3324868,0.869276534510472,0.8676271639649371,755.442
48,2011-07-22,Another Earth,175000,1321194,2102779,1927779,0.9167767987030496,0.8675440548473577,754.9680000000001
66,2006-07-26,Little Miss Sunshine,8000000,59891098,100642353,92642353,0.9205106025293347,0.8664242221773927,748.638725
40,2008-03-19,La misma luna,1700000,12590147,23271741,21571741,0.9269500292221369,0.8649737767160304,740.5968823529412
76,2007-04-13,Aqua Teen Hunger Force Colon Movie Film for Theaters,750000,5520368,5520368,4770368,0.8641394921497988,0.8641394921497987,736.0490666666666
94,2015-03-13,It Follows,2000000,14674077,23250755,21250755,0.9139812879194676,0.8637052265706389,733.70385
26,2009-11-20,The Blind Side,35000000,255959475,305705794,270705794,0.8855108385678814,0.8632596038884671,731.3127857142857
67,2010-09-17,Easy A,8000000,58401464,76200721,68200721,0.8950141167299454,0.8630171325842105,730.0183
66,2019-05-31,MA,5000000,36049540,44300625,39300625,0.8871347751865803,0.8613019750043968,720.9908
31,2015-09-25,The Green Inferno,1000000,7192291,12931420,11931420,0.9226689721623765,0.8609622441583634,719.2291
75,2002-10-11,Bowling for Columbine,3000000,21576018,58240487,55240487,0.9484894417177521,0.860956734463236,719.2006
94,2016-02-19,The Witch,3500000,25138705,40454520,36954520,0.9134830916298103,0.8607724622250827,718.2487142857143
95,2018-02-02,Winchester,3500000,25091816,44378040,40878040,0.9211321635655834,0.8605122881500487,716.9090285714286
65,2006-11-03,Borat,18000000,128505958,261443242,243443242,0.9311514045560986,0.8599286735016597,713.9219888888888
32,2017-02-03,I Am Not Your Negro,1000000,7123919,9617402,8617402,0.8960218154549431,0.8596278256392303,712.3919
18,2012-06-27,Beasts of the Southern Wild,1800000,12795746,23265132,21465132,0.9226309999014835,0.8593282486226281,710.8747777777777
47,2001-01-12,Save the Last Dance,13000000,91038276,122244329,109244329,0.8936555985349635,0.857202919791671,700.2944307692308
57,2007-08-17,Superbad,17500000,121463226,169955142,152455142,0.897031653211175,0.8559234710265311,694.0755771428571
69,2003-12-24,Monster,5000000,34469210,64240813,59240813,0.9221678592392658,0.8549430056563524,689.3842000000001
93,2013-07-19,The Conjuring,20000000,137400141,318000141,298000141,0.9371069461255367,0.8544397418049229,687.000705
43,2018-05-18,Book Club,10000000,68566296,91113683,81113683,0.8902470005520466,0.854155750224571,685.66296
2,2017-08-11,Annabelle: Creation,15000000,102092201,305384865,290384865,0.9508816522390525,0.853073987502728,680.6146733333334
3,2013-10-25,Jackass Presents: Bad Grandpa,15000000,102003019,160903019,145903019,0.9067761432120798,0.8529455289945879,680.0201266666667
63,2011-08-10,The Help,25000000,169705587,213120004,188120004,0.8826951973968619,0.8526860521097634,678.822348
64,2016-12-25,Hidden Figures,25000000,169607287,231771716,206771716,0.8921352422484546,0.8526006727529343,678.429148
45,2018-01-05,Insidious: The Last Key,10000000,67745330,167885588,157885588,0.9404356257191056,0.8523883491304862,677.4533
95,2018-07-13,Eighth Grade,2000000,13539710,14341016,12341016,0.8605398669104057,0.8522863488213559,676.9855
35,2017-05-12,Lowriders,916000,6179955,6188421,5272421,0.8519816282699577,0.8517788559949061,674.6675764192139
94,2003-03-07,Bringing Down the House,20000000,132675402,164675402,144675402,0.8785489529274082,0.8492561567667231,663.3770099999999
95,2017-11-17,Wonder,20000000,132422809,304604712,284604712,0.9343411338955255,0.848968616879287,662.114045
71,2006-09-22,Jackass: Number Two,11000000,72778712,85278712,74278712,0.8710111850657407,0.8488569020017832,661.6246545454546
91,2019-03-15,Five Feet Apart,7000000,45729221,80504421,73504421,0.9130482535859739,0.8469250110339732,653.2745857142858
70,2014-01-03,Paranormal Activity: The Marked Ones,5000000,32462372,90904854,85904854,0.9449974365505278,0.8459755189793278,649.24744
80,2002-08-02,Martin Lawrence Live: RunTelDat,3000000,19184820,19184820,16184820,0.8436263670964856,0.8436263670964856,639.494
97,2012-03-09,Silent House,2000000,12739737,16610760,14610760,0.8795961172155882,0.843010887901375,636.98685
14,2015-05-15,Pitch Perfect 2,29000000,184296230,287625468,258625468,0.8991744361107827,0.8426446379288388,635.5042413793104
85,2014-07-11,Boyhood,4000000,25379975,57273049,53273049,0.9301591224870882,0.8423954318315916,634.4993750000001
47,2007-10-26,Saw IV,10000000,63300095,135759694,125759694,0.9263404350336852,0.8420223539948873,633.00095
48,2006-02-24,Madea's Family Reunion,10000000,63257940,63320521,53320521,0.842073314589436,0.8419170779193884,632.5794
49,2002-09-13,Barbershop,12000000,75781642,77063461,65063461,0.8442841802809764,0.8416503036447798,631.5136833333333
93,2004-05-19,Shrek 2,70000000,441226247,937008132,867008132,0.9252941382156543,0.8413512331237176,630.32321
59,2012-11-16,Silver Linings Playbook,21000000,132092958,236412453,215412453,0.9111721919318692,0.8410210482227221,629.0140857142857
56,2016-02-12,Deadpool,58000000,363070709,801025593,743025593,0.9275928253643201,0.8402515031858436,625.9839810344827
36,2006-06-16,Wordplay,500000,3121270,3177636,2677636,0.8426503224409594,0.8398087957786414,624.254
6,2014-11-28,The Imitation Game,15000000,91125143,227740463,212740463,0.9341355514852009,0.8353912048181916,607.5009533333333
57,2014-12-25,American Sniper,58000000,350126372,547326372,489326372,0.894030320906956,0.8343455259634084,603.6661586206897
33,2012-10-19,The Sessions,1000000,6002451,11495204,10495204,0.9130071984803402,0.8334013888659816,600.2451
5,2018-10-05,A Star is Born,36000000,215288866,433449571,397449571,0.9169453555647885,0.8327828063342579,598.0246277777778
30,2005-12-09,Brokeback Mountain,13900000,83043761,176980863,163080863,0.9214604349623949,0.8326183709333685,597.4371294964029
82,2009-11-20,The Twilight Saga: New Moon,50000000,296623634,687557727,637557727,0.9272788334178667,0.8314362233186045,593.247268
65,2008-12-12,Gran Torino,25000000,148095302,274543085,249543085,0.9089396114274741,0.8311897834544407,592.381208
98,2010-10-15,Jackass 3D,20000000,117229692,171685793,151685793,0.8835081246355659,0.8293947577717768,586.14846
73,2008-05-30,The Strangers,9000000,52597610,83051676,74051676,0.8916337341584775,0.8288895636132516,584.4178888888889
52,2012-02-24,Act of Valor,12000000,70012847,82497035,70497035,0.8545402268093635,0.828602884839121,583.4403916666668
38,2018-08-15,Crazy Rich Asians,30000000,174532921,238099711,208099711,0.874002367016733,0.8281126573249754,581.7764033333333
8,2003-03-12,Bend it Like Beckham,5600000,32543449,74566042,68966042,0.9248987897198566,0.8279223569696008,581.1330178571428
66,2009-01-30,Taken,25000000,145000989,226941585,201941585,0.8898394932775323,0.8275873828695058,580.003956
35,2015-08-14,Straight Outta Compton,28000000,161197785,202182981,174182981,0.8615115878620861,0.8263003427745611,575.706375
39,2002-12-27,Chicago,30000000,170687518,306770545,276770545,0.9022070388146293,0.8242402235879954,568.9583933333333
84,2001-04-06,Pokemon 3: The Movie,3000000,17052128,68452128,65452128,0.95617375109215,0.8240688786760222,568.4042666666667
67,2001-08-10,The Others,17000000,96522687,207765056,190765056,0.9181768083271905,0.823875603463049,567.7805117647058
99,2016-07-29,Bad Moms,20000000,113257297,180998716,160998716,0.8895019785665219,0.8234109366039347,566.286485
60,2015-03-20,Do You Believe?,2300000,12985600,14304931,12004931,0.8392162814347024,0.8228807294233612,564.5913043478262
99,2007-02-09,Das Leben der Anderen,2000000,11284657,81197047,79197047,0.9753685623567074,0.8227682064239967,564.23285
69,2003-06-27,28 Days Laterâ¦,8000000,45064915,82955633,74955633,0.9035629081391013,0.8224783071265085,563.3114375
20,2009-01-16,Paul Blart: Mall Cop,26000000,146336178,185904750,159904750,0.8601434336669718,0.8223269163145699,562.8314538461539
48,2011-02-11,Justin Bieber: Never Say Never,13000000,73013910,99034125,86034125,0.8687321163285888,0.8219517349502307,561.6454615384615
30,2016-11-18,Manchester by the Sea,8500000,47695371,77733867,69233867,0.8906525517378416,0.821785640371683,561.1220117647059
49,2005-01-07,White Noise,10000000,56094360,92094360,82094360,0.8914157175314537,0.8217289581341154,560.9436
100,2019-01-18,Glass,20000000,111035005,245303505,225303505,0.9184683480164706,0.819876623592713,555.175025
21,2015-06-19,The Overnight,200000,1109808,1165996,965996,0.8284728249496567,0.8197886481265227,554.904
72,2014-04-11,Oculus,5000000,27695246,44115496,39115496,0.8866611405661174,0.8194636003594263,553.90492
34,2008-04-04,Shine a Light,1000000,5505267,16173879,15173879,0.9381719128726016,0.8183557673042924,550.5267
54,2018-07-06,Sorry to Bother You,3200000,17493096,18285560,15085560,0.8249985234250414,0.8170706889163588,546.65925
73,2013-11-01,Dallas Buyers Club,5000000,27298285,60611845,55611845,0.9175078732548069,0.8168383105385558,545.9657
74,2015-08-26,No Escape,5000000,27288872,42844516,37844516,0.8832989500920023,0.8167751309031754,545.77744
54,2006-08-11,Step Up,12000000,65328121,110989157,98989157,0.891881330353739,0.816311875861239,544.4010083333334
89,2003-11-07,Elf,32000000,173840591,220678483,188678483,0.8549926591619718,0.8159233133301992,543.251846875
82,2007-06-01,Knocked Up,27500000,148761765,219265952,191765952,0.8745815310167262,0.8151406713949649,540.9518727272728
55,2012-02-03,Chronicle,12000000,64575175,123681790,111681790,0.9029768246400705,0.814170073871267,538.1264583333334
67,2014-01-17,Ride Along,25000000,134202565,153733800,128733800,0.8373812395192206,0.8137144398097012,536.81026
68,2001-07-13,Legally Blonde,18000000,96493426,141809235,123809235,0.8730689154341745,0.813458794591872,536.0745888888889
35,2012-03-23,October Baby,1000000,5355847,5391992,4391992,0.8145397841836561,0.8132881689861566,535.5847
83,2001-05-18,Shrek,50000000,267655011,491812794,441812794,0.8983353003216099,0.8131923635085614,535.310022
77,2012-06-08,Safety Not Guaranteed,750000,4010957,4422318,3672318,0.8304056831733946,0.8130122063138547,534.7942666666667
49,2018-07-04,The First Purge,13000000,69488745,136617305,123617305,0.9048436799423031,0.812919343988728,534.5288076923077
93,2011-05-06,Jumping the Broom,7000000,37295394,38158601,31158601,0.8165551195128983,0.812309262639778,532.7913428571429
36,2014-09-12,The Skeleton Twins,1000000,5284309,5797192,4797192,0.8275026944079132,0.8107604986763643,528.4309000000001
27,2011-06-24,Bad Teacher,19000000,100292856,215448997,196448997,0.9118120749478354,0.810554801630138,527.8571368421052
17,2008-10-24,Saw V,10800000,56746769,118209778,107409778,0.9086369995551468,0.8096807943373834,525.4330462962963
76,2005-07-15,Wedding Crashers,40000000,209218368,283218368,243218368,0.8587662223941633,0.808812197598253,523.04592
51,2015-06-05,Insidious Chapter 3,10000000,52218558,120453155,110453155,0.9169801737447226,0.8084972013206493,522.1855800000001
89,2008-11-21,Twilight,37000000,192769854,402280159,365280159,0.9080242980613917,0.8080612749750798,520.9996054054054
85,2011-05-13,Bridesmaids,32500000,169211718,289632023,257132023,0.8877886510498185,0.8079329234160958,520.65144
19,2008-10-01,Religulous,2500000,13011160,13881317,11381317,0.8199018147917809,0.8078572548489144,520.4463999999999
87,2010-07-09,The Kids Are All Right,4000000,20811365,36275469,32275469,0.8897326454966027,0.8077973261244518,520.284125
58,2009-02-20,Madea Goes To Jail,17500000,90508336,90508336,73008336,0.8066476440357936,0.8066476440357936,517.1904914285715
76,2015-02-27,The Lazarus Effect,5000000,25801570,38359310,33359310,0.8696535469485767,0.8062133428314634,516.0314
28,2016-08-12,Sausage Party,19000000,97670358,141344255,122344255,0.8655764254443875,0.8054681032294363,514.0545157894737
70,2018-03-23,Unsane,1500000,7690044,14244931,12744931,0.894699384644264,0.8049425985078889,512.6696
77,2001-03-16,Memento,5000000,25544867,39723096,34723096,0.8741286429436416,0.8042659607505492,510.89734
38,2012-03-23,The Hunger Games,80000000,408010692,677923379,597923379,0.8819925636463409,0.8039267069011025,510.013365
71,2004-01-30,You Got Served,8000000,40066497,50811858,42811858,0.8425564363342117,0.8003319331859733,500.8312125
96,2002-12-06,Empire,3500000,17504595,18495444,14995444,0.8107642076610867,0.8000525005005829,500.13128571428575
97,2013-02-22,Dark Skies,3500000,17418667,27704111,24204111,0.8736649589658373,0.799066139791294,497.6762
78,2011-08-26,Our Idiot Brother,5000000,24814830,25861249,20861249,0.8066605367745388,0.7985075859878952,496.29659999999996
37,2013-06-14,20 Feet From Stardom,1000000,4946250,5892466,4892466,0.8302917657904177,0.7978266363406621,494.625
10,2012-07-20,Burn,225000,1109276,1109276,884276,0.7971649977102181,0.7971649977102182,493.0115555555555
72,2005-10-05,The Squid and the Whale,1500000,7372734,11191423,9691423,0.8659687869898226,0.7965476578973282,491.51559999999995
26,2016-07-08,The Secret Life of Pets,75000000,368384330,886750534,811750534,0.9154215338764036,0.7964082782782862,491.1791066666667
53,2017-11-03,Lady Bird,10000000,48958273,78610769,68610769,0.8727909658281043,0.7957444291386667,489.58272999999997
29,2010-12-22,True Grit,35000000,171243005,252276928,217276928,0.8612635714352761,0.7956120893814027,489.26572857142855
79,2018-03-09,The Strangers: Prey at Night,5000000,24431472,29960051,24960051,0.8331110985091449,0.7953459374040173,488.62944
69,2014-08-13,Letâs Be Cops,17000000,82390774,136890774,119890774,0.8758133984982801,0.7936662180161094,484.6516117647059
22,2013-07-03,Despicable Me 2,76000000,368065385,975216835,899216835,0.922068613591971,0.7935149484377619,484.2965592105263
41,2001-08-10,American Pie 2,30000000,145096820,286500000,256500000,0.8952879581151831,0.7932415059130862,483.6560666666666
65,2003-06-06,Whale Rider,4300000,20779666,39374600,35074600,0.8907925413845474,0.7930669337996097,483.24804651162793
80,2006-07-21,Clerks II,5000000,24148068,27342246,22342246,0.8171327988198189,0.7929440980537242,482.96136
69,2004-04-30,Mean Girls,18000000,86047227,130953026,112953026,0.8625461316182186,0.7908125499500408,478.04015
9,2013-01-18,Mama,15000000,71628180,148095566,133095566,0.8987140506286326,0.7905852138083084,477.52119999999996
54,2009-11-06,Precious (Based on the Novel Push by Sapphire),10000000,47566524,68722848,58722848,0.8544879862953292,0.7897681150718517,475.66524000000004
50,2016-03-16,Miracles from Heaven,13000000,61705123,73798736,60798736,0.8238452214140903,0.7893205722967281,474.6547923076923
2,2008-10-03,Beverly Hills Chihuahua,20000000,94514402,154218168,134218168,0.8703135936616755,0.7883920378610658,472.57201000000003
73,2002-03-13,Kissing Jessica Stein,1500000,7025722,9345061,7845061,0.8394874040950615,0.786498811083046,468.38146666666665
90,2005-06-24,Rize,700000,3278611,4857731,4157731,0.8558998017798846,0.7864949516731323,468.373
98,2018-01-19,Forever My Girl,3500000,16376066,16376066,12876066,0.7862734554196351,0.786273455419635,467.88759999999996
43,2004-12-22,Meet the Fockers,60000000,279167575,516567575,456567575,0.8838486910449228,0.7850753261728193,465.27929166666667
96,2003-01-24,Darkness Falls,7000000,32539681,47289758,40289758,0.8519764047005697,0.7848780386015463,464.85258571428574
31,2009-12-16,Crazy Heart,8500000,39471742,47417251,38917251,0.8207403461664193,0.7846560711711178,464.3734352941176
55,2012-05-04,The Best Exotic Marigold Hotel,10000000,46383639,134639780,124639780,0.9257277455444446,0.7844067387640715,463.83639
100,2016-04-08,Hardcore Henry,2000000,9252038,17187434,15187434,0.8836359167982841,0.7838314109820993,462.60190000000006
95,2006-03-31,Brick,450000,2075743,4243996,3793996,0.8939678548236142,0.7832101565559898,461.2762222222222
97,2008-02-14,"Definitely, Maybe",7000000,32241649,55617866,48617866,0.8741411617626611,0.782889516600097,460.5949857142857
73,2014-08-22,If I Stay,11000000,50474843,78356170,67356170,0.8596153946779175,0.7820696539858479,458.8622090909091
73,2012-09-21,House at the End of the Street,6900000,31611916,44103982,37203982,0.8435515414458494,0.7817278775509843,458.14371014492747
23,2001-03-23,The Brothers,6000000,27457409,27958191,21958191,0.7853938403954674,0.7814797455943494,457.62348333333335
58,2012-03-02,Project X,12000000,54731865,103028188,91028188,0.883527020779983,0.7807492947664034,456.098875
66,2015-07-01,Magic Mike XXL,14500000,66013057,123660597,109160597,0.8827435710988843,0.7803464850900633,455.2624620689655
59,2017-11-10,"Three Billboards Outside Ebbing, Missouri",12000000,54513740,160191915,148191915,0.9250898523811267,0.7798720102491592,454.28116666666665
73,2015-07-10,Minions,74000000,336045770,1160336173,1086336173,0.9362253787118641,0.7797919015615046,454.1159054054054
98,2005-10-07,"Good Night, and Good Luck",7000000,31501218,56586901,49586901,0.8762964594933377,0.7777863700381363,450.0174
38,2017-12-20,Jumanji: Welcome to the Jungle,90000000,404508916,964496193,874496193,0.9066870344816383,0.7775079944096955,449.4543511111111
52,2004-01-23,The Butterfly Effect,13000000,57924679,95638592,82638592,0.8640716082478507,0.7755706164552073,445.57445384615386
18,2013-09-27,Don Jon,5500000,24477704,41268579,35768579,0.8667266929641556,0.7753057231184755,445.0491636363636
53,2010-06-30,The Twilight Saga: Eclipse,68000000,300531751,706102828,638102828,0.9036967459929222,0.7737343898814871,441.9584573529412
38,2009-06-12,"Food, Inc.",1000000,4417674,4731944,3731944,0.7886703646535124,0.7736365336147484,441.7674
77,2010-06-11,The Karate Kid,40000000,176591618,351774938,311774938,0.886290932982838,0.7734886827980703,441.479045
56,2018-06-08,Hereditary,10000000,44069456,70133905,60133905,0.8574156108946166,0.7730854676309142,440.69456
72,2019-05-03,The Intruder,8000000,35095904,36005871,28005871,0.7778140126092213,0.7720531717889358,438.69879999999995
79,2007-01-12,Stomp the Yard,14000000,61356221,75525718,61525718,0.8146326791623484,0.7718242784215801,438.25872142857145
73,2011-09-30,50/50,8000000,35016118,41334735,33334735,0.8064581761562037,0.7715337833851257,437.70147499999996
30,2005-07-08,Murderball,350000,1531154,1772979,1422979,0.8025921344810063,0.7714142405009555,437.47257142857137
84,2012-06-29,Ted,50000000,218665740,556016627,506016627,0.9100746316350716,0.7713404944002659,437.33148
24,2008-12-17,The Wrestler,6000000,26238243,46634275,40634275,0.8713392670948568,0.7713261516786776,437.30405
89,2014-04-18,A Haunted House 2,4000000,17329487,21206861,17206861,0.81138179761729,0.7691795492849846,433.237175
55,2009-07-17,(500) Days of Summer,7500000,32425665,34439060,26939060,0.7822240212131227,0.7687017367261396,432.3422
60,2016-11-25,Lion,12000000,51739495,149570720,137570720,0.9197703935636601,0.7680688611282348,431.16245833333335
83,2013-07-05,The Way Way Back,5000000,21502690,26853810,21853810,0.8138066814355207,0.7674709536341732,430.0538
44,2014-02-07,The Lego Movie,60000000,257784718,457729388,397729388,0.8689181827232819,0.7672476457661854,429.64119666666664
13,2010-03-19,Diary of a Wimpy Kid,15000000,64003625,76954311,61954311,0.80507914624822,0.7656382743946144,426.69083333333333
84,2014-08-29,"As Above, So Below",5000000,21222315,41824066,36824066,0.8804516041075491,0.7643989357428725,424.44629999999995
54,2016-06-24,The Shallows,13000000,55121623,118763442,105763442,0.8905387063470256,0.764157887731281,424.0124846153846
21,2003-08-06,Freaky Friday,26000000,110222438,160822438,134822438,0.838331016969162,0.7641133650119407,423.93245384615386
75,2003-04-04,Phone Booth,11000000,46566212,97837138,86837138,0.8875682565448717,0.7637772211319228,423.32919999999996
10,2006-08-02,Quinceanera,400000,1692693,2797199,2397199,0.8569998058772365,0.7636901670887751,423.17324999999994
3,2014-07-02,Tammy,20000000,84525432,96407655,76407655,0.7925475938606742,0.7633848236350924,422.62715999999995
22,2005-08-19,The 40 Year-old Virgin,26000000,109449237,177344230,151344230,0.853392467293692,0.7624469506352064,420.9586038461539
72,2004-10-22,Sideways,17000000,71502303,109793192,92793192,0.8451634414636566,0.762245420262897,420.6017823529412
61,2018-05-04,Overboard,12000000,50316123,85369830,73369830,0.8594351189407313,0.7615078570342154,419.30102500000004
71,2005-09-09,The Exorcism of Emily Rose,18000000,75072454,144529078,126529078,0.8754575878495535,0.7602316290339997,417.0691888888889
42,2012-02-10,The Vow,30000000,125014030,197618160,167618160,0.8481920892290465,0.7600269345768631,416.71343333333334
85,2016-04-01,Godâs Not Dead 2,5000000,20773069,23551286,18551286,0.7876973682031632,0.7593037408194234,415.46137999999996
78,2015-02-13,Fifty Shades of Grey,40000000,166167230,570998101,530998101,0.9299472276178375,0.7592786495869251,415.418075
73,2013-11-15,The Best Man Holiday,17000000,70525195,72835710,55835710,0.7665980052916352,0.758951393186506,414.85408823529417
95,2005-02-11,Ong-Bak,1100000,4563167,24062965,22962965,0.954286597682372,0.758939350674652,414.83336363636363
32,2008-08-15,Star Wars: The Clone Wars,8500000,35161554,68695443,60195443,0.8762654460209247,0.7582586935719622,413.6653411764706
4,2005-01-21,Are We There Yet?,20000000,82674398,98114471,78114471,0.796156471148889,0.7580871408340948,413.37199
5,2011-11-16,The Descendants,20000000,82624961,175507800,155507800,0.8860449507087433,0.7579423970923266,413.124805
15,2005-11-18,Walk the Line,29000000,119519402,187707495,158707495,0.8455043044498569,0.7573615704670276,412.13586896551726
8,2007-09-28,The Game Plan,22000000,90648202,146590987,124590987,0.8499225603822426,0.7573035149665738,412.0372818181818
36,2017-07-21,Girls Trip,28000000,115108515,140886353,112886353,0.8012582524582775,0.7567512707465647,411.1018392857143
99,2005-09-30,Capote,7000000,28750530,49924079,42924079,0.8597870979252317,0.7565262275165014,410.7218571428572
79,2009-06-19,The Proposal,40000000,163958031,314709717,274709717,0.8728987449726568,0.7560351282823102,409.89507749999996
57,2018-03-16,"Love, Simon",10000000,40826341,65520633,55520633,0.8473763218984773,0.7550600971074043,408.26341
90,2013-08-07,We're the Millers,37000000,150394119,267816276,230816276,0.8618455885033661,0.7539797417211507,406.4705918918919
6,2003-10-03,School of Rock,20000000,81261177,131944672,111944672,0.8484213140489675,0.7538800108691509,406.305885
14,2013-03-15,The Call,12800000,51872378,69821476,57021476,0.8166753163453605,0.7532405396953269,405.25295312500003
25,2003-05-30,Finding Nemo,94000000,380529370,936429370,842429370,0.8996186973503406,0.7529757032945972,404.81847872340427
7,2007-04-13,Disturbia,20000000,80818974,118537627,98537627,0.83127720280751,0.7525333593074319,404.09487
26,2003-12-17,The Lord of the Rings: The Return of the King,94000000,377845905,1141403341,1047403341,0.9176452384328528,0.7512213345278944,401.96372872340424
33,2015-02-20,The DUFF,8500000,34030343,43528634,35028634,0.8047262406626405,0.7502229113588423,400.3569764705882
89,2018-06-01,Upgrade,3000000,11977130,16553285,13553285,0.8187670906409211,0.7495226318825963,399.23766666666666
44,2014-09-12,No Good Deed,13200000,52543632,54323210,41123210,0.7570099410546615,0.7487802137469294,398.05781818181816
43,2014-10-10,Whiplash,3300000,13092006,38969037,35669037,0.9153173839014807,0.7479377873795658,396.7274545454545
83,2007-12-14,Alvin and the Chipmunks,55000000,217326974,362605033,307605033,0.8483198108284394,0.7469251101798343,395.1399527272727
84,2018-11-02,Bohemian Rhapsody,55000000,216303339,894985342,839985342,0.9385464795690475,0.7457274573093853,393.27879818181816
90,2006-03-03,Dave Chappelle's Block Party,3000000,11718595,12051924,9051924,0.7510770894340191,0.7439966139285469,390.6198333333333
75,2016-10-21,Ouija: Origin of Evil,9000000,35144505,81831866,72831866,0.8900183945457141,0.7439144469384332,390.4945
45,2013-08-16,Lee Daniels' The Butler,30000000,116632095,177025498,147025498,0.8305328874148966,0.7427809214950654,388.77365
15,2007-08-31,Halloween,15000000,58269151,77514401,62514401,0.8064875712578878,0.7425739050153657,388.46100666666666
47,2009-08-14,District 9,30000000,115646235,212453431,182453431,0.8587925840557502,0.7405881825724806,385.48745
91,2006-08-11,Half Nelson,700000,2697938,4911725,4211725,0.8574838778636833,0.740542592157418,385.4197142857143
32,2013-02-08,Identity Thief,35000000,134506920,175361578,140361578,0.800412379957028,0.7397903394115336,384.30548571428574
85,2014-06-13,22 Jump Street,50000000,191719337,331333876,281333876,0.849094814561008,0.7392021024984037,383.438674
74,2009-02-13,Friday the 13th,17000000,65002019,92670237,75670237,0.8165538305464786,0.7384696619961912,382.3648176470588
75,2012-09-28,Pitch Perfect,17000000,65001093,116044347,99044347,0.853504281427858,0.7384659362574103,382.35937058823527
90,2016-02-19,Race,5000000,19115191,23745772,18745772,0.789436199421101,0.7384279340970227,382.30382000000003
48,2004-06-18,Dodgeball: A True Underdog Story,30000000,114326736,167791704,137791704,0.8212068935184065,0.73759418794218,381.08912
34,2014-10-31,Nightcrawler,8500000,32381218,50334418,41834418,0.8311294669186401,0.7375021532543958,380.95550588235295
61,2017-10-27,Jigsaw,10000000,38052832,102445196,92445196,0.9023868332488719,0.7372074698671574,380.52832
54,2001-06-22,The Fast and the Furious,38000000,144512310,206512310,168512310,0.8159915987574784,0.7370466225334021,380.29555263157897
90,2013-03-01,The Last Exorcism Part II,4000000,15179303,25448707,21448707,0.842821091067613,0.7364832891207191,379.482575
62,2001-08-31,Jeepers Creepers,10000000,37904175,58939035,48939035,0.83033315696465,0.7361768195719864,379.04175000000004
57,2007-11-21,This Christmas,13000000,49121934,49733545,36733545,0.7386070106202967,0.7353524395028909,377.86103076923075
16,2006-09-30,The Queen,15000000,56441711,128885873,113885873,0.8836179664159158,0.7342390984568132,376.27807333333334
80,2013-12-13,American Hustle,40000000,150117807,257878294,217878294,0.8448880695635437,0.7335426036432839,375.2945175
76,2002-01-25,A Walk to Remember,11000000,41227069,46060861,35060861,0.7611855323329714,0.7331850100719021,374.79153636363634
58,2014-02-14,About Last Night,13000000,48637684,50445860,37445860,0.7422979804487426,0.7327175364682249,374.1360307692308
96,2012-03-23,Serbuan maut,1100000,4105123,9297407,8197407,0.8816874425310197,0.7320421336948978,373.19300000000004
92,2015-01-16,Still Alice,5000000,18656400,41699612,36699612,0.880094807596771,0.7319954546429107,373.128
1,2006-08-04,The Descent,7000000,26024456,57051053,50051053,0.8773028781782521,0.7310222353927398,371.7779428571429
35,2013-06-28,The Heat,43000000,159581587,229727774,186727774,0.8128219359318739,0.7305453542080641,371.1199697674419
71,2018-11-16,Green Book,23000000,85080171,322034439,299034439,0.928579067284167,0.7296667398564585,369.91378695652173
54,2012-08-03,Celeste and Jesse Forever,840000,3103407,3787689,2947689,0.7782288883802234,0.7293297334187878,369.4532142857143
75,2015-09-02,A Walk in the Woods,8000000,29499394,37119358,29119358,0.7844790311297948,0.728807988394609,368.74242499999997
80,2009-01-16,My Bloody Valentine,14000000,51545952,102836002,88836002,0.8638609073892235,0.7283976829063125,368.18537142857144
17,2007-10-12,Why Did I Get Married?,15000000,55204525,55934178,40934178,0.7318276492773345,0.7282831434560845,368.0301666666667
65,2001-02-16,Recess: School's Out,10000000,36696761,44451470,34451470,0.7750355612536548,0.7274963858526915,366.96761000000004
9,2016-10-21,Tyler Perryâs Boo! A Madea Halloween,20000000,73206343,73206343,53206343,0.7267996299173147,0.7267996299173147,366.031715
6,2003-11-26,Les Triplettes de Belleville,2000000,7301288,17403168,15403168,0.8850783949221197,0.7260757280085377,365.0644
50,2010-07-09,Despicable Me,69000000,251513985,543464573,474464573,0.8730368023455319,0.7256613782331031,364.51302173913047
27,2002-12-18,The Lord of the Rings: The Two Towers,94000000,342548984,934699645,840699645,0.8994329349509919,0.7255866915664243,364.41381276595746
70,2003-07-02,"Legally Blonde 2: Red, White & Blonde",25000000,90639088,125339088,100339088,0.8005410730290298,0.7241808081740628,362.556352
18,2012-02-03,The Woman in Black,15000000,54333290,128955898,113955898,0.8836811636176578,0.7239261601865081,362.2219333333333
73,2004-01-01,Barbershop 2: Back in Business,18000000,65070412,65842412,47842412,0.7266199786241124,0.7233765785899742,361.50228888888887
28,2018-11-09,Dr. Seussâ The Grinch,75000000,270620950,511002426,436002426,0.8532296596180935,0.7228595938341064,360.82793333333336
51,2001-08-03,The Princess Diaries,30000000,108244774,165334774,135334774,0.8185499681996724,0.7228503613486227,360.81591333333336
29,2016-12-21,Sing,75000000,270329045,634454789,559454789,0.8817882671857333,0.7225603338331624,360.43872666666664
68,2016-01-22,The Boy,10000000,35819556,68220952,58220952,0.8534174662352998,0.7208228935054359,358.19556
36,2019-01-16,Dragon Ball Super: Broly,8500000,30376755,122747755,114247755,0.9307522976693137,0.7201807763864179,357.3735882352941
33,2006-06-30,The Devil Wears Prada,35000000,124740460,326073155,291073155,0.8926621236268285,0.7194174207791121,356.40131428571425
30,2002-04-05,National Lampoonâs Van Wilder,6000000,21305259,39241323,33241323,0.8470999563393924,0.7183793916797726,355.08765
81,2019-05-17,John Wick: Chapter 3 â Parabellum,40000000,141744320,256498033,216498033,0.8440533850019817,0.7178017433079505,354.3608
4,2017-04-07,Gifted,7000000,24801212,36964656,29964656,0.8106299163179009,0.7177557290345327,354.30302857142857
94,2011-09-02,Apollo 18,5000000,17686929,26517819,21517819,0.8114475402370006,0.7173053614903978,353.73858
30,2017-06-30,Despicable Me 3,75000000,264624300,1034727750,959727750,0.9275171657472218,0.7165793164119848,352.8324
58,2005-04-15,The Amityville Horror,18500000,65233369,109175673,90675673,0.83054833103708,0.7164028121865054,352.6128054054054
51,2014-10-17,Dear White People,1250000,4404154,5403771,4153771,0.7686800569454184,0.71617704558015,352.33232
45,2007-03-09,300,60000000,210614939,454161935,394161935,0.8678885318735485,0.7151199231883546,351.02489833333334
95,2018-03-23,"Paul, Apostle of Christ",5000000,17547999,25529498,20529498,0.8041481270019489,0.7150672278930492,350.95998000000003
81,2012-08-31,The Possession,14000000,49130588,82925064,68925064,0.8311728767553319,0.715045136443309,350.93277142857147
42,2018-02-16,Black Panther,200000000,700059566,1348258224,1148258224,0.8516604635226018,0.7143100248700837,350.029783
39,2017-07-28,An Inconvenient Sequel,1000000,3496795,5839322,4839322,0.8287472415461931,0.7140238418323065,349.6795
94,2006-06-09,Cars,70000000,244082982,461651246,391651246,0.8483703865060076,0.7132122877784245,348.68997428571424
79,2015-11-04,Brooklyn,11000000,38322743,62076141,51076141,0.8227982631845623,0.7129641789993999,348.38857272727273
96,2014-10-10,Addicted,5000000,17390770,17499242,12499242,0.7142733382394506,0.7124911662910843,347.8154
82,2003-12-25,Cheaper by the Dozen,40000000,138614544,190212113,150212113,0.7897084503761335,0.7114299925121854,346.53636
11,2004-06-23,White Chicks,20000000,69148997,111448997,91448997,0.8205457156334929,0.7107694852030898,345.74498500000004
9,2002-03-29,The Rookie,22000000,75600072,80491516,58491516,0.7266792689058061,0.7089949861423412,343.63669090909093
80,2008-10-17,The Secret Life of Bees,11000000,37780486,39994347,28994347,0.7249611301317158,0.7088444018427926,343.45896363636365
76,2002-10-11,Brown Sugar,8000000,27362712,28315272,20315272,0.7174669556414645,0.7076313195855732,342.03389999999996
12,2009-04-24,Obsessed,20000000,68261644,73964713,53964713,0.7296007895007989,0.7070096934670955,341.30822
70,2017-05-19,"Everything, Everything",10000000,34121140,61603136,51603136,0.8376706017044327,0.706926556381176,341.21139999999997
61,2014-10-10,St. Vincent,13000000,44137712,54837234,41837234,0.7629347971854307,0.7054672883814186,339.52086153846153
26,2002-07-25,Austin Powers in Goldmember,63000000,213117789,296338663,233338663,0.787405398397171,0.7043888250924,338.2822047619048
13,2003-04-18,Holes,20000000,67383924,71232214,51232214,0.7192281570807275,0.7031933017139221,336.91962
71,2010-09-17,Devil,10000000,33679655,63354114,53354114,0.8421570539207603,0.7030848445448743,336.79654999999997
71,2004-03-26,Scooby-Doo 2: Monsters Unleashed,25000000,84185387,181185387,156185387,0.862019777566278,0.7030363476264592,336.741548
72,2004-07-09,Anchorman: The Legend of Ron Burgundy,25000000,84136909,89476265,64476265,0.7205962944474716,0.7028652431241561,336.547636
25,2008-08-06,Pineapple Express,26000000,87341380,102404019,76404019,0.7461037149332976,0.7023175040284456,335.92838461538463
34,2011-07-08,Horrible Bosses,35000000,117538559,212417601,177417601,0.8352302265196941,0.7022253778013392,335.8244542857143
54,2004-12-15,Million Dollar Baby,30000000,100492203,231928227,201928227,0.87064963851942,0.7014693766838807,334.97401
55,2002-09-27,Sweet Home Alabama,38000000,127214072,182365114,144365114,0.7916268130098609,0.7012909075027486,334.7738736842105
93,2009-05-08,Next Day Air,3000000,10027047,10172519,7172519,0.7050877958546944,0.7008092212991521,334.2349
74,2005-12-16,The Family Stone,18000000,60062868,92357499,74357499,0.8051051598961121,0.7003140109792959,333.6826
75,2003-11-26,Bad Santa,18000000,60060328,77147031,59147031,0.7666792906132707,0.7003013370156753,333.6684888888889
72,2002-11-22,Friday After Next,10000000,33253609,33526835,23526835,0.7017314637662636,0.699280760773966,332.53609
6,2001-04-11,Kingdom Come,7000000,23247539,23393939,16393939,0.7007771970338129,0.6988928591538227,332.10769999999997
77,2016-03-25,My Big Fat Greek Wedding 2,18000000,59689605,92096558,74096558,0.8045529562570622,0.6984399544945892,331.60891666666663
59,2008-02-14,Step Up 2 the Streets,17500000,58017783,148586910,131086910,0.8822238109669286,0.6983683433749959,331.5301885714286
73,2015-03-06,The Second Best Exotic Marigold Hotel,10000000,33078266,90384306,80384306,0.8893613234138237,0.6976866925249346,330.78265999999996
5,2005-05-19,Star Wars Ep. III: Revenge of the Sith,115000000,380270577,848998877,733998877,0.8645463461549432,0.6975837549482562,330.67006695652174
57,2006-03-17,Thank You For Smoking,7500000,24793509,40016662,32516662,0.8125780706046897,0.6975014710503463,330.58011999999997
73,2003-08-15,Freddy vs. Jason,25000000,82622655,114576403,89576403,0.7818049847489102,0.6974195515745651,330.49062
44,2012-03-16,21 Jump Street,42000000,138447667,202812429,160812429,0.7929121000764703,0.6966362748460038,329.63730238095235
74,2007-02-16,Bridge to Terabithia,25000000,82234139,137984788,112984788,0.8188206079644083,0.6959900072645012,328.936556
21,2018-08-10,BlacKkKlansman,15000000,49275340,93017335,78017335,0.8387397359857708,0.6955880974134323,328.5022666666667
14,2012-06-29,Tyler Perry's Madea's Witness Protection,20000000,65653242,66950887,46950887,0.701273561917111,0.6953691944108411,328.26621
19,2017-12-01,The Shape of Water,19500000,63859435,195790794,176290794,0.9004038974375884,0.6946418332702129,327.48428205128204
38,2013-11-22,The Hunger Games: Catching Fire,130000000,424668047,864868047,734868047,0.8496880530493226,0.6938785460352754,326.66772846153845
8,2010-06-11,Winter's Bone,2000000,6531503,16131551,14131551,0.8760193610645374,0.6937917658462378,326.57515
78,2014-01-31,That Awkward Moment,8000000,26068955,53068955,45068955,0.8492527316582738,0.6931215693149189,325.8619375
79,2008-03-21,Shutter,8000000,25928550,47782426,39782426,0.832574428096221,0.691459800104518,324.106875
75,2001-12-21,Jimmy Neutron: Boy Genius,25000000,80936232,102992536,77992536,0.7572639632837083,0.6911148519985462,323.74492799999996
11,2002-04-26,Dogtown and Z-Boys,400000,1293295,1600566,1200566,0.7500884062262975,0.6907124824575986,323.32375
85,2005-02-11,Hitch,55000000,177784257,366784257,311784257,0.8500480897139485,0.6906362749543116,323.2441036363636
92,2002-08-02,Signs,70702619,227969295,408269295,337566676,0.8268235699674646,0.6898590268483306,322.4340176139727
35,2001-03-30,Spy Kids,35000000,112692062,197692062,162692062,0.822956978414237,0.6894191180919202,321.97732
75,2017-04-28,How to Be a Latin Lover,10000000,32149404,62556228,52556228,0.8401438142977548,0.6889522430960151,321.49404000000004
31,2001-11-02,Le Fabuleux destin d'AmÃ©lie Poulain,10350000,33201661,174201661,163851661,0.9405861003816719,0.6882686080072922,320.78899516908217
97,2001-08-31,O (Othello),5000000,16017403,16017403,11017403,0.6878395330379088,0.6878395330379088,320.34806
67,2009-10-02,Zombieland,23600000,75590286,102236596,78636596,0.7691628934907027,0.687790571396965,320.2978220338983
76,2008-01-18,Cloverfield,25000000,80048433,171302226,146302226,0.8540591060387037,0.6876890769367091,320.193732
77,2010-02-05,Dear John,25000000,80014842,142033509,117033509,0.8239851977465401,0.6875579658083933,320.059368
2,2007-06-22,1408,22500000,71985628,131263370,108763370,0.8285888896498697,0.6874376090738556,319.93612444444443
22,2006-02-03,When a Stranger Calls,15000000,47860214,67215435,52215435,0.776836972043698,0.686587276855887,319.0680933333333
77,2013-04-05,Evil Dead,17000000,54239856,97778356,80778356,0.8261373917966058,0.6865773389958852,319.05797647058824
23,2002-02-08,Big Fat Liar,15000000,47811275,52461017,37461017,0.714073404257489,0.6862664716638491,318.7418333333334
39,2011-05-26,The Hangover Part II,80000000,254464305,586464305,506464305,0.8635893108618095,0.6856140589148643,318.08038125
23,2002-11-15,El crimen de padre Amaro,1800000,5719000,5719000,3919000,0.6852596607798567,0.6852596607798567,317.72222222222223
64,2008-04-25,Harold & Kumar Escape from Guantanamo Bay,12000000,38108728,43353117,31353117,0.7232032935486508,0.685111505164906,317.5727333333333
59,2017-06-28,Baby Driver,34000000,107825862,228104185,194104185,0.8509453037873901,0.6846767614990178,317.1348882352941
91,2013-06-12,This is the End,32000000,101470202,126539117,94539117,0.7471137719413673,0.6846364807670334,317.09438125
63,2012-03-02,Doctor Seuss' The Lorax,67500000,214030500,350976753,283476753,0.8076795701623007,0.684624387645686,317.08222222222224
78,2015-09-11,The Perfect Guy,18000000,57027435,60278166,42278166,0.7013844117287842,0.6843624476534846,316.81908333333337
67,2002-12-25,Catch Me if You Can,52000000,164606800,355612291,303612291,0.8537733331607485,0.6840956752697944,316.5515384615384
83,2014-07-25,Lucy,40000000,126573960,457507776,417507776,0.9125697920378077,0.6839792323792351,316.4349
78,2004-08-27,Jet Li's Hero,17000000,53652140,177535958,160535958,0.9042447502381461,0.6831440460716013,315.60082352941174
35,2017-03-17,Beauty and the Beast,160000000,504014165,1259199706,1099199706,0.8729351672831472,0.6825486045615404,315.00885312500003
36,2015-07-17,Trainwreck,35000000,110212700,141123897,106123897,0.7519909757027189,0.68243224238223,314.89342857142856
77,2008-10-03,Nick and Norah's Infinite Playlist,10000000,31487293,33886017,23886017,0.7048930241639197,0.6824115683745821,314.87293
15,2010-03-31,The Last Song,20000000,62950384,92678948,72678948,0.7842012621895535,0.6822894678450254,314.75192
65,2013-11-22,Philomena,12000000,37709979,98963392,86963392,0.8787430406589134,0.6817818434743759,314.249825
95,2009-12-23,Alvin and the Chipmunks: The Squeakquel,70000000,219614612,443483213,373483213,0.842158625291641,0.6812598243690634,313.73516
34,2003-02-21,Old School,24000000,75155000,86765463,62765463,0.7233922442158811,0.6806599693965804,313.1458333333333
84,2013-12-25,Lone Survivor,40000000,125095601,149804632,109804632,0.7329855594852367,0.6802445515250373,312.73900249999997
41,2014-06-06,Obvious Child,1000000,3122616,3324070,2324070,0.6991639766912249,0.67975569202233,312.2616
78,2019-02-13,Happy Death Day 2U,9000000,28051045,64179495,55179495,0.8597682951540829,0.6791563380259096,311.6782777777778
54,2012-10-05,Taken 2,45000000,139854287,377807404,332807404,0.8808916936948118,0.6782365348585989,310.78730444444443
78,2003-12-19,Calendar Girls,10000000,31011616,93074616,83074616,0.8925593203629227,0.6775401836524739,310.11616000000004
67,2002-02-15,Crossroads,12000000,37188667,57000000,45000000,0.7894736842105263,0.6773210505232683,309.9055583333334
62,2016-01-22,Dirty Grandpa,11500000,35593113,105078449,93578449,0.8905579582736323,0.6769037875388983,309.5053304347826
79,2012-12-25,Parental Guidance,25000000,77267296,120832383,95832383,0.7931018210573568,0.6764478467060631,309.069184
22,2013-04-12,42,31000000,95020213,97470701,66470701,0.6819557089263162,0.6737536254523024,306.5168161290323
6,2015-12-18,Star Wars Ep. VII: The Force Awakens,306000000,936662225,2053311220,1747311220,0.8509724210244173,0.673308059370068,306.09876633986926
27,2012-10-12,Argo,44500000,136025503,227140757,182640757,0.8040862389130807,0.6728554644638954,305.6752876404494
80,2018-08-10,Slender Man,10000000,30564825,51723644,41723644,0.806664820444592,0.6728265252622909,305.64825
61,2011-07-15,Harry Potter and the Deathly Hallows: Part II,125000000,381193157,1341693157,1216693157,0.9068341376358379,0.6720822561880354,304.9545256
44,2018-06-15,Incredibles 2,200000000,608581744,1242520711,1042520711,0.8390368882953773,0.6713670727526786,304.290872
34,2015-06-12,Jurassic World,215000000,652270625,1648854864,1433854864,0.8696064737447989,0.6703822129043447,303.3816860465116
81,2002-09-20,The Banger Sisters,10000000,30306281,38067218,28067218,0.7373067819140343,0.6700353962929335,303.06281
81,2015-04-01,Woman in Gold,11000000,33307793,58586407,47586407,0.812243136876443,0.6697469568157818,302.7981181818182
77,2017-01-13,The Bye Bye Man,7400000,22395806,31187727,23787727,0.7627271779055909,0.6695809920839643,302.646027027027
23,2012-11-02,Flight,31000000,93772375,160558438,129558438,0.8069238815091114,0.6694122336135776,302.4915322580645
9,2014-10-10,Meet the Mormons,2000000,6047363,6049171,4049171,0.6693761839432213,0.6692773362538349,302.36815
33,2019-03-29,Unplanned,6000000,18107621,18107621,12107621,0.6686478030438123,0.6686478030438123,301.7936833333333
60,2014-09-19,The Maze Runner,34000000,102427862,348319861,314319861,0.9023885692237342,0.6680590677563883,301.2584176470588
88,2015-12-25,Daddyâs Home,50000000,150357137,242757137,192757137,0.7940328320810603,0.6674584193499242,300.714274
16,2010-04-02,Why Did I Get Married Too?,20000000,60095852,60831067,40831067,0.6712206281043862,0.6671983284303882,300.47926
56,2003-10-08,Mystic River,30000000,90135191,156822020,126822020,0.8087003343025425,0.6671666230784378,300.45063666666664
10,2003-08-15,American Splendor,2000000,6003587,8685632,6685632,0.7697346606441535,0.6668658253807266,300.17935
37,2003-05-23,Bruce Almighty,81000000,242704995,484468608,403468608,0.8328065045651009,0.6662615040123092,299.6357962962963
62,2014-07-02,Earth to Echo,13000000,38934842,42174545,29174545,0.6917571961950034,0.666108828693847,299.49878461538464
42,2011-10-21,Martha Marcy May Marlene,1000000,2981038,5438911,4438911,0.8161396647233242,0.6645463761280467,298.1038
84,2018-07-27,Teen Titans Go! To The Movies,10000000,29790236,51620593,41620593,0.8062788623912166,0.6643195441620536,297.90236
85,2016-09-09,When the Bough Breaks,10000000,29747603,30768449,20768449,0.6749917423526939,0.6638384612030758,297.47603
81,2007-11-09,No Country for Old Men,25000000,74273505,164035753,139035753,0.8475942010032411,0.6634062173314696,297.09402
91,2015-11-25,Creed,37000000,109767581,173567581,136567581,0.786826550287637,0.6629241560857573,296.66913783783787
87,2006-12-15,The Pursuit of Happyness,55000000,162586036,307311093,252311093,0.8210282633695881,0.661717565953819,295.61097454545455
30,2003-01-10,Just Married,19000000,56127162,101564935,82564935,0.8129275620567277,0.6614829732527719,295.4061157894737
11,2017-10-06,The Florida Project,2000000,5904366,11295324,9295324,0.8229355793600963,0.6612676111203133,295.2183
15,2018-05-18,Deadpool 2,110000000,324591735,786680557,676680557,0.8601719604975568,0.661112751376741,295.08339545454544
98,2001-08-08,The Deep End,3000000,8823109,9981635,6981635,0.6994480363186993,0.6599837993614269,294.10363333333333
60,2006-01-13,Hoodwinked,17500000,51386611,109843390,92343390,0.8406822659060321,0.6594443638246547,293.63777714285715
91,2011-03-18,Limitless,27000000,79249455,155564919,128564919,0.8264390186838975,0.6593036507317306,293.5165
34,2006-09-27,The Last King of Scotland,6000000,17606684,49155371,43155371,0.8779380588949273,0.6592203279163754,293.4447333333333
35,2003-04-16,A Mighty Wind,6000000,17583468,18504539,12504539,0.6757552295682697,0.6587703859102197,293.0578
35,2006-12-20,Rocky Balboa,24000000,70269899,156229050,132229050,0.8463794025502939,0.6584597339466789,292.79124583333333
80,2011-03-25,Diary of a Wimpy Kid: Rodrick Rules,18000000,52698535,73695194,55695194,0.7557506938647858,0.6584345276391459,292.7696388888889
29,2002-12-19,25th Hour,4500000,13084595,25344490,20844490,0.8224466146290574,0.6560841202956607,290.7687777777778
19,2002-05-03,Spider-Man,139000000,403706375,821706375,682706375,0.8308398179337478,0.6556903516819619,290.43624100719427
57,2015-12-18,Sisters,30000000,87044645,106030660,76030660,0.7170629702767105,0.6553492750760257,290.1488166666667
12,2017-08-25,All Saints,2000000,5802208,5941994,3941994,0.6634126523857143,0.6553036361330031,290.1104
13,2004-07-02,Before Sunset,2000000,5792822,11217346,9217346,0.8217047062647438,0.6547451311295255,289.6411
43,2001-12-19,The Lord of the Rings: The Fellowship of the Ring,109000000,315544750,887210985,778210985,0.8771430901523386,0.654565636094405,289.49059633027525
88,2013-08-30,One Direction: This is Us,10000000,28873374,68541786,58541786,0.8541035974755605,0.6536601506980099,288.73374
85,2019-01-11,The Upside,37500000,108235497,119024536,81524536,0.6849389104108752,0.6535332581324961,288.627992
75,2008-07-18,The Dark Knight,185000000,533720947,1001996207,816996207,0.8153685625678222,0.6533769172076358,288.4978091891892
60,2018-04-06,Blockers,21000000,60311495,94045328,73045328,0.7767034211417712,0.6518076694998193,287.19759523809523
26,2013-02-22,Snitch,15000000,42930462,57907734,42907734,0.7409672428211402,0.6505977503806039,286.20308
82,2001-04-13,Bridget Jones's Diary,25000000,71500556,281527158,256527158,0.9111986204897504,0.6503523692878695,286.002224
89,2002-09-06,Swimfan,10000000,28564995,34084228,24084228,0.7066091683226623,0.6499211709996798,285.64995
27,2003-05-02,The Lizzie McGuire Movie,15000000,42734455,55534455,40534455,0.7298974123361794,0.6489951726306092,284.89636666666667
28,2015-12-04,Krampus,15000000,42725475,61788393,46788393,0.7572359585399802,0.648921398767363,284.8365
59,2004-11-19,SpongeBob SquarePants: The Movie,30000000,85416609,142051255,112051255,0.7888086240420755,0.6487802506887156,284.72203
70,2002-11-08,8 Mile,41000000,116724075,245768384,204768384,0.833176264038909,0.6487442714795555,284.69286585365853
33,2012-05-25,Moonrise Kingdom,16000000,45512466,68848446,52848446,0.7676055026717669,0.6484479658825782,284.4529125
90,2006-10-06,Employee of the Month,10000000,28444855,38364855,28364855,0.7393447727092934,0.6484425742370633,284.44854999999995
33,2004-11-05,The Incredibles,92000000,261441092,614726752,522726752,0.85034000927944,0.648104284998932,284.1751
18,2013-10-18,12 Years a Slave,20000000,56671993,181025343,161025343,0.8895182317096894,0.6470919948059706,283.359965
84,2011-01-21,No Strings Attached,25000000,70662220,149228078,124228078,0.8324712055863911,0.6462041526575304,282.64887999999996
3,2013-03-15,Spring Breakers,5000000,14124286,31149251,26149251,0.8394824967059402,0.6459998048750925,282.48571999999996
19,2002-12-13,Drumline,20000000,56398162,56398162,36398162,0.6453785142856251,0.6453785142856251,281.99081
20,2016-06-03,Me Before You,20000000,56245075,208265198,188265198,0.9039685929667424,0.6444133108543282,281.225375
46,2007-03-02,Wild Hogs,60000000,168213584,253555383,193555383,0.7633653078467674,0.6433106139632576,280.35597333333334
73,2012-11-09,Lincoln,65000000,182207973,273346281,208346281,0.7622063861187123,0.6432647873208052,280.3199584615385
73,2015-01-16,The Wedding Ringer,23000000,64460211,80171596,57171596,0.7131153532231042,0.6431907428909905,280.26178695652175
4,2017-06-09,It Comes at Night,5000000,13985117,19720203,14720203,0.7464529143031641,0.6424770704456745,279.70234
60,2009-12-04,Up in the Air,30000000,83823381,166842739,136842739,0.8201899574424992,0.6421046294947229,279.41127
87,2003-07-25,Spy Kids 3-D: Game Over,40000000,111760631,167851995,127851995,0.7616948192960113,0.6420922140283908,279.40157750000003
34,2011-11-25,The Artist,16000000,44667095,128256712,112256712,0.875250193533731,0.6417944798066675,279.16934375
6,2011-02-11,Gnomeo and Juliet,36000000,99967670,193737977,157737977,0.8141820176020523,0.6398835743595904,277.6879722222222
91,2015-08-21,Sinister 2,10000000,27740955,54104225,44104225,0.8151715508354477,0.6395221433436592,277.40955
68,2008-07-18,Mamma Mia!,52000000,144130063,615748772,563748772,0.9155499736830981,0.6392147556335974,277.1731980769231
27,2012-05-04,The Avengers,225000000,623279547,1517935897,1292935897,0.851772396683758,0.6390062836443436,277.013132
55,2017-06-02,Wonder Woman,150000000,412563408,821133378,671133378,0.8173256574159137,0.6364195246321991,275.042272
36,2014-10-03,Gone Girl,61000000,167767189,368567189,307567189,0.834494220265494,0.6364008936216962,275.0281786885246
22,2013-08-02,The Spectacular Now,2500000,6852971,6916951,4416951,0.6385690747267112,0.635194720654735,274.11884
97,2004-02-06,What the #$'! Do We Know,4000000,10941801,10941801,6941801,0.6344294691522904,0.6344294691522904,273.545025
29,2012-09-21,End of Watch,15000000,41003371,57586606,42586606,0.7395227633314593,0.6341764192997693,273.3558066666667
21,2019-02-08,What Men Want,20000000,54611903,69911903,49911903,0.713925681582434,0.6337794711163974,273.05951500000003
5,2002-03-15,Y Tu MamÃ¡ TambiÃ©n,5000000,13649881,33649881,28649881,0.851411064425458,0.6336964402839849,272.99762
83,2017-12-08,"I, Tonya",11000000,30014534,53797409,42797409,0.7955291861732599,0.6335108850932019,272.8594
79,2007-06-22,Sicko,9000000,24538513,36535837,27535837,0.7536665165218469,0.6332296093084369,272.65014444444444
31,2009-09-11,I Can Do Bad All By Myself,19000000,51733921,51733921,32733921,0.6327361307100616,0.6327361307100616,272.28379473684214
74,2002-03-15,Ice Age,65000000,176387405,386116343,321116343,0.8316569573435538,0.6314929628904059,271.36523846153847
11,2014-02-28,Son of God,22000000,59700064,70949793,48949793,0.6899215759516028,0.6314911823210105,271.36392727272727
36,2014-06-20,Think Like a Man Too,24000000,65028687,70027933,46027933,0.6572796172635854,0.6309321146219667,270.9528625
6,2004-09-24,Shaun of the Dead,5000000,13542874,30332385,25332385,0.8351596816405965,0.6308021473137829,270.85748
32,2004-07-16,A Cinderella Story,19000000,51438175,70164105,51164105,0.7292062657964496,0.6306245312941215,270.72723684210524
99,2013-05-24,Before Midnight,3000000,8110621,23251930,20251930,0.8709784521112871,0.6301146361049296,270.35403333333335
6,2002-05-16,Star Wars Ep. II: Attack of the Clones,115000000,310676740,656695615,541695615,0.8248808163581235,0.629840328567887,270.15368695652177
22,2016-04-15,Barbershop: The Next Cut,20000000,54030051,54404202,34404202,0.6323813370151078,0.6298356261037029,270.15025499999996
61,2004-06-25,The Notebook,30000000,81001787,116025023,86025023,0.7414350868088171,0.6296378004598837,270.00595666666663
62,2014-11-21,The Hunger Games: Mockingjay - Part 1,125000000,337135885,766575131,641575131,0.836937052944912,0.6292296205727255,269.708708
14,2001-03-30,Amores Perros,2000000,5383834,20883834,18883834,0.904232144346675,0.6285175211568559,269.1917
15,2002-10-18,The Ring,48000000,129094024,248218486,200218486,0.8066219773816524,0.6281779859925971,268.9458833333333
79,2010-10-29,Saw 3D,17000000,45710178,133735284,116735284,0.8728832100883713,0.6280915817041886,268.8834
7,2008-10-31,The Haunting of Molly Hartley,5000000,13442412,15318257,10318257,0.6735921064648543,0.6280429434836545,268.84824
98,2016-05-13,The Darkness,4000000,10753574,10898293,6898293,0.6329700440243257,0.6280306435795207,268.83935
43,2005-08-03,Junebug,1000000,2678010,3553253,2553253,0.7185677462314111,0.6265883995952218,267.801
24,2018-09-14,A Simple Favor,20000000,53548586,97628717,77628717,0.7951422428300476,0.6265074114188561,267.74293
56,2013-11-22,Frozen,150000000,400738009,1272469910,1122469910,0.8821190200088896,0.6256906092478989,267.1586726666667
35,2009-01-09,The Unborn,16000000,42670410,78208812,62208812,0.795419472680393,0.6250328975043831,266.69006249999995
16,2018-09-28,Night School,29000000,77339130,103008792,74008792,0.718470633069845,0.6250281067294137,266.6866551724138
68,2015-07-24,Paper Towns,12000000,32000304,85450484,73450484,0.8595677936710107,0.6250035624661566,266.6692
85,2012-01-13,Contraband,25000000,66528000,98406855,73406855,0.745952657464767,0.6242183742183742,266.11199999999997
45,2016-12-16,Rogue One: A Star Wars Story,200000000,532177324,1049102856,849102856,0.8093609231390748,0.6241854153109312,266.088662
92,2016-01-08,The Forest,10000000,26594261,40749230,30749230,0.7545965899232943,0.6239790231433767,265.94261
69,2008-05-30,Sex and the City,57500000,152647258,415247258,357747258,0.8615282849140451,0.6233145570161502,265.47349217391303
62,2009-04-10,Hannah Montana the Movie,30000000,79576189,169173206,139173206,0.8226669535363655,0.6230028055251553,265.25396333333333
39,2001-04-06,Along Came a Spider,28000000,74058698,105159085,77159085,0.7337367475192467,0.6219215196032747,264.49535000000003
69,2008-10-10,Quarantine,12000000,31691811,41924774,29924774,0.7137730545667342,0.6213532890247263,264.09842499999996
70,2002-08-21,One Hour Photo,12000000,31597131,52223306,40223306,0.7702175346769505,0.6202186837786,263.30942500000003
99,2006-07-28,Scoop,4000000,10525717,40103262,36103262,0.9002574902759779,0.6199783824702868,263.142925
64,2002-11-15,Harry Potter and the Chamber of Secrets,100000000,262233381,879225135,779225135,0.8862634881337874,0.6186602955784641,262.233381
93,2009-11-06,The Fourth Kind,10000000,26218170,49486874,39486874,0.7979262137268966,0.6185851262693011,262.1817
8,2016-07-15,Hillaryâs America: The Secret History of the Democratic Party,5000000,13099931,13099931,8099931,0.6183186003040779,0.6183186003040779,261.99862
71,2008-02-01,The Eye,12000000,31418697,57577765,45577765,0.7915862138796115,0.6180618184134116,261.822475
80,2015-02-20,"McFarland, USA",17000000,44480275,45707924,28707924,0.628073241742504,0.6178081183176138,261.6486764705882
61,2019-04-05,Pet Sematary,21000000,54724696,109501146,88501146,0.8082211851919796,0.6162610021625338,260.59379047619046
32,2006-03-31,Ice Age: The Meltdown,75000000,195330621,651899282,576899282,0.8849515529915861,0.6160356240304995,260.440828
25,2015-01-09,Selma,20000000,52076908,66776576,46776576,0.7004937779379403,0.6159526214574798,260.38454
72,2004-04-07,Johnson Family Vacation,12000000,31203964,31286759,19286759,0.6164511638933262,0.6154334750546437,260.0330333333333
73,2001-12-21,How High,12000000,31155435,31222395,19222395,0.6156604898503142,0.6148344582574437,259.628625
61,2003-03-28,Raising Victor Vargas,800000,2073984,2900578,2100578,0.7241929022422426,0.6142689625378016,259.248
33,2005-05-27,Madagascar,75000000,193595521,556559566,481559566,0.8652435344180212,0.612594343027182,258.12736133333334
93,2002-06-07,The Divine Secrets of the Ya-Ya Sisterhood,27000000,69586544,73826768,46826768,0.6342789921400867,0.6119939510144375,257.72794074074073
77,2018-07-13,Hotel Transylvania 3: Summer Vacation,65000000,167500092,527079962,462079962,0.8766790531111103,0.6119405116505846,257.6924492307692
40,2017-11-01,A Bad Moms Christmas,28000000,72110659,127710550,99710550,0.7807542133363296,0.6117078891208025,257.53806785714283
86,2017-01-27,A Dogâs Purpose,25000000,64321890,203671625,178671625,0.8772533974725247,0.6113298287721334,257.28756000000004
1,2009-07-31,The Collector,3000000,7712114,10473836,7473836,0.7135719902431162,0.6110016008580786,257.0704666666667
90,2016-06-10,The Conjuring 2: The Enfield Poltergeist,40000000,102470008,311262102,271262102,0.8714909404550639,0.6096418768699617,256.17502
63,2008-01-18,27 Dresses,30000000,76808654,160247805,130247805,0.8127899474192487,0.6094190115608588,256.02884666666665
41,2013-02-14,Safe Haven,28000000,71399120,94050951,66050951,0.7022890284224771,0.6078383038894597,254.99685714285712
91,2016-06-17,Central Intelligence,50000000,127440871,217194805,167194805,0.769791915603138,0.6076611874380551,254.88174199999997
92,2013-12-18,Anchorman 2: The Legend Continues,50000000,127352707,172185754,122185754,0.7096159302470517,0.6073895782992661,254.70541400000002
63,2001-11-16,Harry Potter and the Sorcererâs Stone,125000000,317871467,975047606,850047606,0.8718011313183,0.6067592943156487,254.2971736
93,2011-06-10,Super 8,50000000,127004179,257972745,207972745,0.8061810754465555,0.6063121670980606,254.00835800000002
38,2013-09-27,Baggage Claim,8500000,21569509,22885836,14385836,0.6285912387032748,0.6059251974627703,253.7589294117647
92,2002-01-18,Snow Dogs,32000000,81150692,116898028,84898028,0.7262571443891251,0.6056718776963725,253.59591250000003
12,2001-06-01,The Animal,22000000,55762229,55762229,33762229,0.605467708258219,0.605467708258219,253.46467727272727
80,2007-07-27,The Simpsons Movie,72500000,183135014,527071022,454571022,0.8624473800041315,0.6041172115781202,252.6000193103448
94,2002-06-28,Mr. Deeds,50000000,126293452,171269535,121269535,0.7080624992646825,0.6040966557791135,252.586904
32,2001-12-14,Not Another Teen Movie,15000000,37882551,62401343,47401343,0.7596205581665125,0.6040393372663841,252.55033999999998
33,2014-12-03,Wild,15000000,37880356,52460543,37460543,0.7140708208071732,0.6040163930877523,252.53570666666664
100,2001-11-14,The Wash,4000000,10097096,10097096,6097096,0.603846492100303,0.603846492100303,252.4274
36,2002-08-02,The Master of Disguise,16000000,40363530,40363530,24363530,0.6036025590427795,0.6036025590427795,252.27206249999998
84,2009-10-23,Saw VI,11000000,27693292,69752402,58752402,0.8422993375912704,0.602791896319152,251.75719999999998
7,2001-11-02,"Monsters, Inc.",115000000,289423425,559757719,444757719,0.7945539720194551,0.6026582851750856,251.67254347826088
65,2017-08-18,The Hitmanâs Bodyguard,30000000,75468583,172778667,142778667,0.8263674531069277,0.6024835924108977,251.56194333333332
41,2001-08-03,Rush Hour 2,90000000,226164286,347425832,257425832,0.7409519048082758,0.6020591863031814,251.2936511111111
44,2008-08-01,Frozen River,1000000,2511476,6030129,5030129,0.8341660684207586,0.6018277698054849,251.1476
42,2015-12-11,The Big Short,28000000,70259870,133162752,105162752,0.789730990239673,0.6014794789685777,250.92810714285716
93,2006-06-16,Nacho Libre,32000000,80197993,99296462,67296462,0.6777327272748147,0.6009875209720024,250.618728125
83,2018-12-21,Second Act,15700000,39282227,63288854,47588854,0.7519310430237841,0.600328158584288,250.20526751592357
86,2012-02-24,Tyler Perry's Good Deeds,14000000,35025791,35579177,21579177,0.6065114153708502,0.6002945372454258,250.18422142857145
38,2002-02-01,The Singles Ward,500000,1250798,1250798,750798,0.6002551970821828,0.6002551970821828,250.1596
11,2015-06-19,Dope,7000000,17506470,18190831,11190831,0.6151907518683452,0.6001478310590314,250.0924285714286
16,2013-10-04,Gravity,110000000,274092705,693698673,583698673,0.8414297096399376,0.5986759297369845,249.17518636363636
92,2010-09-17,The Town,37000000,92186262,152566881,115566881,0.7574834082109865,0.5986386778541904,249.15205945945945
42,2014-02-28,The Lunchbox,1700000,4231500,12231500,10531500,0.8610145934676859,0.5982512111544369,248.91176470588238
67,2005-08-12,Four Brothers,30000000,74494381,92494381,62494381,0.6756559730909492,0.5972850623458432,248.31460333333334
36,2019-02-08,The Prodigy,6000000,14856291,19789712,13789712,0.6968121617939664,0.5961306896856019,247.60485
81,2016-11-11,Almost Christmas,17000000,42065185,42493506,25493506,0.5999388706594367,0.5958653218807904,247.44226470588237
37,2018-11-30,The Possession of Hannah Grace,6000000,14836174,42785387,36785387,0.8597652044143015,0.5955830660923767,247.26956666666666
37,2006-10-06,The Texas Chainsaw Massacre: The Beginning,16000000,39517763,50517763,34517763,0.683279720837995,0.5951187824067875,246.98601875000003
13,2014-08-08,The Hundred-Foot Journey,22000000,54235441,94270488,72270488,0.7666289793683894,0.594361185336356,246.5247318181818
82,2006-03-10,The Hills Have Eyes,17000000,41778863,70355813,53355813,0.7583710673629767,0.5930956761556675,245.7580176470588
13,2018-06-22,Jurassic World: Fallen Kingdom,170000000,417719760,1305772799,1135772799,0.8698088977422479,0.59302858931069,245.71750588235295
44,2007-10-26,Bella,3300000,8093373,12405473,9105473,0.7339883775491672,0.5922590000485582,245.25372727272728
12,2017-03-03,Before I Fall,5000000,12241072,18945682,13945682,0.7360876214432398,0.5915390416787026,244.82144
56,2003-10-24,Scary Movie 3,45000000,110000082,155200000,110200000,0.7100515463917526,0.5909093958675412,244.44462666666666
96,2012-08-17,Sparkle,10000000,24397469,24660323,14660323,0.5944903073653982,0.5901214179224903,243.97468999999998
96,2019-03-08,Captain Marvel,175000000,426525952,1123061550,948061550,0.8441759492166747,0.5897084358421407,243.72911542857142
82,2008-04-11,Prom Night,18000000,43869350,57193655,39193655,0.6852797744784802,0.5896907521994286,243.7186111111111
83,2011-04-08,Soul Surfer,18000000,43853424,47158652,29158652,0.6183097006250305,0.5895417425102314,243.63013333333333
12,2005-07-22,The Devil's Rejects,7000000,17044981,20940428,13940428,0.66571838932805,0.5893219241488155,243.49972857142856
46,2016-06-17,Finding Dory,200000000,486295561,1021215193,821215193,0.8041548917692218,0.5887274817217589,243.1477805
27,2006-02-17,Date Movie,20000000,48548426,85146165,65146165,0.765109796782979,0.5880401972249316,242.74212999999997
91,2010-10-01,The Social Network,40000000,96962694,224922135,184922135,0.8221606779608419,0.5874702078719058,242.406735
84,2003-09-26,Under the Tuscan Sun,18000000,43601508,57490024,39490024,0.686902200632235,0.5871702419099817,242.23059999999998
28,2002-02-15,Peter Pan: Return to Neverland,20000000,48430258,109862682,89862682,0.8179545625875035,0.5870350308685119,242.15129000000002
78,2003-04-11,Anger Management,56000000,135560942,195660942,139660942,0.7137906041564492,0.586901660804334,242.07311071428572
87,2012-04-20,The Lucky One,25000000,60457138,96633833,71633833,0.7412914377514136,0.5864838987250769,241.828552
22,2006-08-18,The Illusionist,16500000,39868642,83792062,67292062,0.8030839723218651,0.5861409074329644,241.62813333333335
14,2009-03-13,Sunshine Cleaning,5000000,12062558,17329337,12329337,0.7114719391745916,0.5854942210433309,241.25116000000003
3,2017-10-27,Let There Be Light,3000000,7233471,7241309,4241309,0.5857102631582218,0.5852613496342213,241.11570000000003
43,2008-11-07,Role Models,28000000,67300955,94500826,66500826,0.7037062935301751,0.5839583554200679,240.36055357142857
37,2016-12-16,Fences,24000000,57682904,64282881,40282881,0.6266502118970056,0.5839321820551892,240.34543333333335
45,2001-11-21,Sidewalks of New York,1000000,2402459,3575308,2575308,0.7203038171816246,0.5837598060986681,240.24589999999998
13,2019-05-24,BrightBurn,7000000,16794432,27989498,20989498,0.7499061969600169,0.5831951923113565,239.92045714285712
80,2015-01-30,Black or White,9000000,21571189,21971021,12971021,0.5903695144617995,0.5827768232896202,239.67987777777776
29,2003-02-14,The Jungle Book 2,20000000,47901582,140122225,120122225,0.8572674677411096,0.5824772551353314,239.50790999999998
35,2014-11-07,The Theory of Everything,15000000,35893537,123327692,108327692,0.8783728150851958,0.5820974678533353,239.29024666666666
30,2007-03-16,Premonition,20000000,47852604,81461343,61461343,0.7544847744530802,0.5820499131039975,239.26302
44,2014-10-10,"Alexander and the Terrible, Horrible, No Good, Very Bad Day",28000000,66954149,101379287,73379287,0.7238094602105458,0.5818033621784963,239.12196071428573
47,2008-12-25,Marley & Me,60000000,143153751,247812011,187812011,0.7578809850342565,0.5808702211372722,238.58958499999997
66,2013-04-19,Home Run,1200000,2859955,2859955,1659955,0.5804129785258859,0.5804129785258859,238.32958333333335
37,2013-12-13,Saving Mr. Banks,35000000,83299761,114962525,79962525,0.6955529638897545,0.579830727245424,237.99931714285717
64,2010-11-19,Harry Potter and the Deathly Hallows: Part I,125000000,296131568,960431568,835431568,0.8698501755202614,0.5778903247491669,236.90525440000002
31,2017-10-20,Tyler Perryâs Boo 2! A Madea Halloween,20000000,47319572,47879572,27879572,0.5822853220158275,0.5773419083334059,236.59786
15,2003-09-19,Underworld,22000000,51970690,95708457,73708457,0.7701352556545761,0.5766844734984277,236.2304090909091
85,2018-06-29,Uncle Drew,18000000,42469946,46527161,28527161,0.61312919995269,0.5761708762238595,235.94414444444442
97,2016-10-14,Kevin Hart: What Now?,10000000,23591043,23591043,13591043,0.5761103059326372,0.5761103059326372,235.91043
2,2008-04-11,The Visitor,4000000,9427026,19174817,15174817,0.7913930547550988,0.575688027167847,235.67565
85,2006-04-28,Akeelah and the Bee,8000000,18848430,18959424,10959424,0.5780462528819441,0.5755614658621434,235.605375
39,2016-10-07,Middle School: The Worst Years of My Life,8500000,20007149,23311293,14811293,0.6353698612942663,0.5751518619669399,235.37822352941177
4,2006-04-07,Phat Girlz,3000000,7061128,7301115,4301115,0.5891038560548628,0.5751387030514105,235.3709333333333
92,2009-08-07,Julie & Julia,40000000,94125426,126646119,86646119,0.6841592911346932,0.5750351238782175,235.313565
86,2014-10-17,Birdman or (The Unexpected Virtue of Ignorance),18000000,42340598,103215094,85215094,0.825606902029271,0.5748761035448767,235.22554444444444
38,2006-12-29,El Laberinto del Fauno,16000000,37634615,87041569,71041569,0.8161797841672638,0.5748594744492537,235.21634374999996
93,2009-02-06,He's Just Not That Into You,40000000,93953653,181053657,141053657,0.7790710187091112,0.5742581717392085,234.8841325
56,2009-07-24,The Ugly Truth,38000000,88915214,205298907,167298907,0.8149040316127938,0.5726265698466406,233.9874052631579
58,2007-06-08,Hostel: Part II,7500000,17544812,33606409,26106409,0.7768282829623362,0.5725232051503316,233.93082666666663
32,2005-02-04,Boogeyman,20000000,46752382,67192859,47192859,0.7023493225671495,0.5722143098505654,233.76191
15,2016-01-29,Fifty Shades of Black,5000000,11686940,22113075,17113075,0.7738894296700028,0.5721720142312701,233.73879999999997
36,2011-09-16,Drive,15000000,35060689,81357930,66357930,0.8156295274474165,0.5721704157040383,233.73792666666668
39,2011-02-04,The Roommate,16000000,37300107,52545707,36545707,0.6955031930581884,0.5710468069166665,233.12566875
58,2017-12-22,Pitch Perfect 3,45000000,104897530,185736412,140736412,0.7577211731644735,0.5710099179647032,233.10562222222222
89,2006-11-17,Happy Feet,85000000,198000317,385000317,300000317,0.7792209610050789,0.5707077580082864,232.94154941176473
77,2013-07-26,The To Do List,1500000,3491669,4128828,2628828,0.6367007780416137,0.5704060150031404,232.77793333333335
42,2009-12-25,Sherlock Holmes,90000000,209028679,498438212,408438212,0.8194359946062885,0.5694370723167609,232.25408777777776
75,2006-09-01,Crank,12000000,27838408,43924923,31924923,0.7268065785795457,0.5689408675955895,231.98673333333332
39,2008-03-28,21,35000000,81159365,159846429,124846429,0.7810398379309431,0.5687497062107374,231.8839
96,2018-11-21,Creed II,50000000,115715889,213591522,163591522,0.7659083116604225,0.5679072214533996,231.431778
97,2018-02-09,Peter Rabbit,50000000,115234093,347136477,297136477,0.8559644309577986,0.5661006330826069,230.468186
94,2017-02-10,John Wick: Chapter Two,40000000,92029184,171350009,131350009,0.7665596854447787,0.5653552681723224,230.07296
15,2003-08-20,Thirteen,2000000,4601043,9505996,7505996,0.7896064757443618,0.5653159511875894,230.05214999999998
45,2004-02-06,Miracle,28000000,64378093,64474705,36474705,0.5657211615004675,0.565069440624779,229.92176071428568
16,2004-01-23,Touching the Void,2000000,4593598,15396525,13396525,0.8701005584052245,0.5646114440140386,229.6799
88,2001-12-26,Gosford Park,18000000,41300105,41300105,23300105,0.5641657569635719,0.5641657569635719,229.4450277777778
40,2008-05-09,What Happens in Vegas...,35000000,80277646,218535708,183535708,0.839843107012974,0.5640131251481888,229.36470285714287
5,2004-10-01,Woman Thou Art Loosed,3000000,6879730,6879730,3879730,0.5639363754100815,0.5639363754100815,229.32433333333333
45,2003-01-17,Cidade de Deus,3300000,7563397,32059295,28759295,0.8970657339782426,0.5636881152741288,229.1938484848485
39,2018-11-23,The Favourite,15000000,34366783,94113929,79113929,0.8406187037415046,0.5635320303328945,229.1118866666667
78,2012-12-25,Les Miserables,65000000,148809770,442169052,377169052,0.8529974006412372,0.5632007226407245,228.93810769230768
40,2003-04-18,Malibu's Most Wanted,15000000,34308901,34499204,19499204,0.5652073595669048,0.5627956721784821,228.72600666666668
69,2006-06-02,The Break-Up,52000000,118703275,205727307,153727307,0.7472382215162132,0.5619328952802692,228.27552884615386
46,2013-01-28,Last Vegas,28000000,63914167,112914167,84914167,0.7520240307843745,0.5619124630068323,228.26488214285715
89,2002-01-11,Orange County,18000000,41059716,43308707,25308707,0.5843791873075315,0.561614113453683,228.10953333333336
55,2007-10-05,Michael Clayton,21500000,49033882,92987651,71487651,0.7687865026292577,0.5615276799825883,228.06456744186048
17,2006-12-22,Night at the Museum,110000000,250863268,579446407,469446407,0.8101636343393531,0.5615141233032171,228.05751636363638
52,2013-04-19,Filly Brown,1250000,2850357,2940411,1690411,0.5748893607050171,0.5614584418723689,228.02856
77,2014-12-25,Into the Woods,56200000,128002372,213116401,156916401,0.7362943455487502,0.5609456362261787,227.7622277580071
57,2016-03-04,Zootopia,150000000,341268248,1019429616,869429616,0.8528588951647643,0.5604630642344435,227.51216533333331
17,2002-07-12,The Crocodile Hunter: Collision Course,12500000,28436931,33436931,20936931,0.6261618627618665,0.5604307651905194,227.49544799999998
95,2016-01-15,Ride Along 2,40000000,90862685,124827316,84827316,0.6795573174063921,0.5597752806886568,227.15671249999997
96,2006-04-14,Scary Movie 4,40000000,90710620,178710620,138710620,0.7761744657368432,0.5590372990505411,226.77655
7,2018-04-27,Avengers: Infinity War,300000000,678815482,2048134200,1748134200,0.8535252231030565,0.5580536862298612,226.27182733333333
39,2011-07-08,Sholem Aleichem: Laughing in the Darkness,500000,1131261,1131261,631261,0.5580153474750743,0.5580153474750743,226.25220000000002
97,2015-03-27,Get Hard,40000000,90411453,106511453,66511453,0.6244535317718368,0.5575781754110289,226.02863250000001
14,2014-01-17,Devil's Due,7000000,15821461,36146087,29146087,0.8063414167071528,0.5575629835955099,226.0208714285714
59,2008-07-11,Journey to the Center of the Earth,45000000,101704370,243180937,198180937,0.8149526004992736,0.5575411361380047,226.0097111111111
57,2002-08-07,Spy Kids 2: The Island of Lost Dreams,38000000,85846296,119721296,81721296,0.6825961523169614,0.5573484032438627,225.91130526315789
41,2009-09-04,All About Steve,15000000,33862903,40127259,25127259,0.6261892694938371,0.55703738690094,225.75268666666668
40,2004-01-30,Osama,500000,1127331,1971479,1471479,0.7463832990359015,0.5564745403080373,225.46620000000001
34,2015-11-06,Spotlight,20000000,45055776,92088460,72088460,0.7828175213267764,0.5561057476848251,225.27888
77,2016-08-12,Hell or High Water,12000000,27007844,37584304,25584304,0.680717780486237,0.5556846373964541,225.06536666666665
29,2003-08-15,Open Range,26000000,58331254,68613992,42613992,0.6210685424045871,0.5542698259152803,224.35097692307693
83,2002-03-01,40 Days and 40 Nights,17000000,37939782,95092667,78092667,0.8212270142765057,0.5519215160487744,223.1751882352941
64,2002-05-10,The New Guy,13000000,28972187,28972187,15972187,0.5512937977378097,0.5512937977378097,222.8629769230769
17,2012-08-03,Diary of a Wimpy Kid: Dog Days,22000000,49008662,77229695,55229695,0.7151354799471887,0.5510997627317391,222.76664545454548
30,2005-08-19,Red Eye,26000000,57891803,96666486,70666486,0.7310339800704041,0.5508863318698158,222.66078076923077
43,2009-08-28,Halloween 2,15000000,33392973,38512850,23512850,0.6105196057939103,0.550803697532412,222.61981999999998
42,2003-01-31,The R.M.,500000,1111615,1111615,611615,0.550203982493939,0.550203982493939,222.323
69,2012-09-28,Looper,30000000,66486205,170466405,140466405,0.824012244524075,0.548778577450766,221.62068333333332
84,2003-10-10,Good Boy!,17000000,37667746,45312217,28312217,0.6248252430464835,0.5486854987288063,221.57497647058824
70,2013-02-01,Warm Bodies,30000000,66380662,115121608,85121608,0.7394060027375573,0.5480611507007869,221.26887333333332
40,2007-02-02,The Messengers,16000000,35374833,53774833,37774833,0.7024630462357735,0.5477010449773714,221.09270625000002
57,2011-11-18,"The Twilight Saga: Breaking Dawn, Part 1",127500000,281287133,689420051,561920051,0.815061949801051,0.5467265116602401,220.6173592156863
39,2007-08-08,Daddy Day Camp,6000000,13235267,18209872,12209872,0.6705083923709074,0.546665737835134,220.58778333333336
34,2001-10-26,Thirteen Ghosts,19000000,41867960,68467960,49467960,0.7224979391820642,0.5461923628473897,220.35768421052632
74,2015-02-06,The SpongeBob Movie: Sponge Out of Water,74000000,162994032,311013181,237013181,0.7620679620006201,0.5459956472516736,220.2622054054054
41,2017-02-10,The Lego Batman Movie,80000000,175750384,310660018,230660018,0.7424837592071473,0.5448089604174066,219.68798
88,2013-09-18,Enough Said,8000000,17550872,25621449,17621449,0.6877616094234171,0.5441821922010485,219.3859
12,2001-12-21,A Beautiful Mind,78000000,170708996,317668058,239668058,0.7544606766853468,0.543082076354078,218.85768717948716
90,2006-06-06,The Omen,25000000,54607383,119295584,94295584,0.7904365009856525,0.542186447572483,218.429532
43,2009-07-01,Ice Age: Dawn of the Dinosaurs,90000000,196573705,859701857,769701857,0.8953125443813018,0.5421564649249502,218.41522777777777
44,2009-03-13,The Last House on the Left,15000000,32752215,46526243,31526243,0.6776013055685585,0.5420157079452489,218.3481
6,2003-07-09,Pirates of the Caribbean: The Curse of the Black Pearl,140000000,305411224,634954103,494954103,0.7795116224329682,0.5416016537755011,218.15087428571428
85,2001-10-12,Corky Romano,11000000,23978402,25116103,14116103,0.5620339668140396,0.5412538333455249,217.9854727272727
35,2018-03-30,Acrimony,20000000,43549096,46627836,26627836,0.5710716662896387,0.5407482166794002,217.74548000000001
45,2005-02-18,Because of Winn-Dixie,15000000,32647042,33508485,18508485,0.552352187811535,0.5405403037739223,217.64694666666665
17,2016-04-08,The Boss,29000000,63077560,78652207,49652207,0.6312881595299672,0.5402485448073768,217.50882758620688
71,2002-12-13,About Schmidt,30000000,65005217,107054484,77054484,0.7197688608727496,0.538498579275568,216.68405666666666
91,2006-02-10,Final Destination 3,25000000,54098051,112798051,87798051,0.7783649648343658,0.5378761427098363,216.39220400000002
34,2010-06-25,Grown Ups,75000000,162001186,272223430,197223430,0.724491018278625,0.5370404263583601,216.00158133333332
98,2013-04-26,Mud,10000000,21590086,31556959,21556959,0.6831126852242005,0.5368244480360106,215.90086
39,2011-10-14,Footloose,24000000,51802742,62989834,38989834,0.6189861367153309,0.5367040609549201,215.84475833333335
90,2001-12-07,Ocean's Eleven,85000000,183417150,450728529,365728529,0.8114164191279758,0.5365755056165685,215.78488235294117
47,2001-01-26,The Wedding Planner,28000000,60400856,94728529,66728529,0.7044185073326749,0.53643041085378,215.71734285714282
78,2002-10-25,Frida,12000000,25885000,56131239,44131239,0.7862153016077197,0.5364110488700019,215.70833333333334
100,2016-10-14,The Accountant,40000000,86260045,152962083,112962083,0.7384972849774804,0.5362858899505559,215.6501125
17,2010-10-08,Inside Job,2000000,4311834,7799257,5799257,0.743565316542332,0.5361602510671793,215.5917
1,2014-11-14,Dumb and Dumber To,40000000,86208010,156553592,116553592,0.744496440554363,0.5360059929465951,215.520025
35,2004-10-01,Shark Tale,75000000,161412000,371917043,296917043,0.7983421265263179,0.5353505315589919,215.21599999999998
25,2012-11-16,"The Twilight Saga: Breaking Dawn, Part 2",136200000,292324737,829724737,693524737,0.8358491751222792,0.5340797997536555,214.62902863436125
79,2002-11-01,The Santa Clause 2,65000000,139225854,172825854,107825854,0.6238988641132363,0.5331326895649712,214.19362153846154
72,2014-01-17,The Nut Job,30000000,64251538,122529966,92529966,0.75516193320416,0.5330851068498936,214.1717933333333
99,2010-11-12,Skyline,10000000,21416355,68264973,58264973,0.8535119906954332,0.5330671349069438,214.16355000000001
90,2012-01-13,The Iron Lady,14000000,29959436,115592104,101592104,0.8788844608278781,0.5327014834324652,213.99597142857144
34,2016-11-11,Arrival,47000000,100546139,203127894,156127894,0.7686186811940264,0.5325529108581684,213.9279553191489
73,2001-02-16,Down to Earth,30000000,64172251,71172251,41172251,0.5784874079646575,0.5325082176095085,213.90750333333335
92,2011-04-22,Madea's Big Happy Family,25000000,53345287,54160818,29160818,0.5384116982871271,0.5313550379811435,213.381148
36,2015-06-26,Max,20000000,42656255,43658157,23658157,0.5418954583905133,0.5311355860939972,213.281275
18,2010-09-03,Machete,12500000,26593646,46370970,33870970,0.7304347957353491,0.529962909185149,212.749168
70,2010-02-12,Valentine's Day,52000000,110485654,217569328,165569328,0.7609957227059138,0.5293506612179714,212.47241153846153
42,2015-09-25,Hotel Transylvania 2,80000000,169700110,469500298,389500298,0.8296060719433239,0.5285801523640733,212.1251375
75,2012-08-08,Hope Springs,30000000,63536011,133085295,103085295,0.7745806552106302,0.5278268256406591,211.78670333333335
13,2015-03-13,Cinderella,95000000,201151353,534551353,439551353,0.8222808726105684,0.5277188118143058,211.7382663157895
98,2003-02-07,How to Lose a Guy in 10 Days,50000000,105807520,178890782,128890782,0.7204998522506318,0.5274437960553277,211.61504
46,2005-02-04,The Wedding Date,15000000,31726995,47175038,32175038,0.6820352322768665,0.5272164918234457,211.51330000000002
46,2015-10-02,The Martian,108000000,228433663,655271443,547271443,0.8351828068295659,0.5272150409810659,211.51265092592593
19,2009-01-09,Not Easily Broken,5000000,10572742,10732909,5732909,0.5341430734202629,0.5270857834230703,211.45484
61,2004-08-11,The Princess Diaries 2: Royal Engagement,45000000,95149435,122071435,77071435,0.6313633898053218,0.5270597245270032,211.4431888888889
54,2007-07-02,Transformers,151000000,319246193,708272592,557272592,0.7868052474350159,0.5270108044796638,211.4213198675497
44,2018-12-14,Spider-Man: Into The Spider-Verse 3D,90000000,190173195,375381768,285381768,0.7602440830317577,0.5267471843232165,211.30355
4,2006-09-08,Tom yum goong,5700000,12044087,43044087,37344087,0.8675776303490885,0.5267387224951131,211.29977192982454
100,2017-12-01,The Disaster Artist,10000000,21120616,28717667,18717667,0.6517822983322427,0.5265289610871198,211.20616
79,2012-07-05,Katy Perry: Part of Me,12000000,25326071,32700439,20700439,0.6330324495032008,0.5261799589837681,211.0505916666667
80,2014-12-12,Top Five,12000000,25317379,26001741,14001741,0.5384924417176526,0.5260172863865569,210.97815833333334
48,2004-03-19,Dawn of the Dead,28000000,58990765,103452875,75452875,0.7293453661872618,0.5253494339325825,210.68130357142854
76,2008-04-18,Forgetting Sarah Marshall,30000000,63172463,105173042,75173042,0.7147558021569824,0.5251095402121649,210.57487666666668
93,2013-12-13,Tyler Perry's A Madea Christmas,25000000,52543354,52543354,27543354,0.5242024329090221,0.5242024329090221,210.173416
37,2008-03-21,Meet the Browns,20000000,41975388,41975388,21975388,0.5235303125726914,0.5235303125726914,209.87694000000002
31,2011-12-09,New Yearâs Eve,26000000,54544638,146850273,120850273,0.8229489161385488,0.5233261975265103,209.78706923076925
85,2007-01-26,Smokin' Aces,17000000,35662731,57263440,40263440,0.7031264625387508,0.5233118854526312,209.7807705882353
2,2014-04-25,The Other Woman,40000000,83911193,195111193,155111193,0.7949886965223979,0.5233055499520785,209.7779825
47,2004-01-16,Along Came Polly,42000000,88073507,173044410,131044410,0.7572877390260685,0.5231256091573598,209.69882619047618
36,2018-12-21,Aquaman,160000000,335061807,1146894640,986894640,0.8604928522466545,0.5224761621368561,209.413629375
90,2009-01-30,New in Town,8000000,16734283,29937909,21937909,0.7327802686553695,0.521939481960476,209.1785375
24,2004-12-25,Darkness,10600000,22163442,34409206,23809206,0.6919429062094603,0.5217349362973495,209.08907547169812
43,2009-01-16,Hotel for Dogs,35000000,73178547,122357172,87357172,0.7139521988952147,0.521717751515345,209.08156285714287
16,2014-11-14,Beyond the Lights,7000000,14618727,14618727,7618727,0.5211621367578723,0.5211621367578723,208.83895714285714
86,2019-02-14,Fighting With My Family,11000000,22958583,39049922,28049922,0.7183092964948815,0.5208763537366395,208.7143909090909
20,2014-05-09,Momsâ Night Out,5000000,10429707,10537341,5537341,0.5254969920779825,0.5206001472524587,208.59413999999998
41,2001-03-02,See Spot Run,16000000,33357476,43057552,27057552,0.6284043273059277,0.5203474027831122,208.48422499999998
50,2016-09-09,Sully,60000000,125070033,238524556,178524556,0.7484535722183672,0.5202687761344078,208.450055
25,2016-06-24,Hunt for the Wilderpeople,2500000,5205471,23845533,21345533,0.8951585607249793,0.5197360623082906,208.21884000000003
91,2017-02-10,Fifty Shades Darker,55000000,114434010,381398492,326398492,0.8557938713611903,0.519373654737783,208.06183636363636
97,2016-04-15,The Jungle Book,175000000,364001123,962854547,787854547,0.818248768159995,0.5192322524785178,208.0006417142857
38,2009-07-24,Orphan,20000000,41596251,78769428,58769428,0.7460943857558544,0.5191874383102458,207.98125500000003
1,2016-09-16,Blair Witch,10000000,20777061,38985577,28985577,0.7434948827357358,0.5186999739761076,207.77060999999998
62,2007-12-25,The Bucket List,45000000,93466502,174807445,129807445,0.7425738932343529,0.5185440875919375,207.70333777777776
100,2018-12-14,The Mule,50000000,103804407,170857676,120857676,0.7073587726898498,0.5183248819098788,207.608814
25,2017-12-20,The Greatest Showman,84000000,174340174,386665550,302665550,0.7827579933097221,0.5181833419530716,207.54782619047617
47,2010-06-18,Toy Story 3,200000000,415004880,1068879522,868879522,0.812888173191141,0.5180779560953597,207.50244000000004
3,2003-11-26,The Cooler,4000000,8291572,11131455,7131455,0.6406579373496097,0.5175824318959059,207.2893
91,2004-07-23,The Bourne Supremacy,85000000,176087450,311001124,226001124,0.7266890906799424,0.5172853034103225,207.16170588235295
94,2004-11-12,Finding Neverland,25000000,51676606,115036108,90036108,0.7826769313162089,0.5162220986416949,206.706424
95,2012-01-27,The Grey,25000000,51580136,81249176,56249176,0.6923045718026728,0.5153172919125301,206.32054399999998
10,2001-05-04,The Mummy Returns,98000000,202007640,435040395,337040395,0.7747335623856263,0.5148698336359951,206.13024489795916
36,2010-02-26,The Crazies,19000000,39123589,56445534,37445534,0.663392324359975,0.5143594827151466,205.91362631578946
92,2006-04-07,Friends with Money,6500000,13368437,18110152,11610152,0.6410852874122758,0.5137801075772732,205.6682615384615
48,2013-05-03,Iron Man 3,200000000,408992272,1215392272,1015392272,0.8354440746353535,0.5109932052701475,204.49613599999998
96,2005-01-28,Hide and Seek,25000000,51100486,123696741,98696741,0.7978928159473498,0.5107678623643619,204.40194400000001
32,2016-03-25,The Lobster,4500000,9196278,18019834,13519834,0.7502751690165403,0.5106715999668562,204.36173333333332
39,2017-11-17,The Star,20000000,40847995,62758010,42758010,0.6813155802741355,0.510379885230597,204.239975
77,2004-10-08,Friday Night Lights,30000000,61255921,61950770,31950770,0.5157445177840404,0.5102514253275205,204.18640333333335
56,2004-07-16,Maria Full of Grace,3200000,6529624,14441158,11241158,0.7784111218781763,0.5099258395276666,204.05075
4,2006-02-17,Eight Below,40000000,81612565,120455994,80455994,0.667928521680706,0.5098793917333685,204.03141250000002
3,2001-02-02,Valentine,10000000,20384136,20384136,10384136,0.5094224253605844,0.5094224253605844,203.84136
98,2015-06-19,Inside Out,175000000,356461711,854235992,679235992,0.7951385780523281,0.5090636817371951,203.6924062857143
64,2010-04-16,Death at a Funeral,21000000,42739347,48977233,27977233,0.5712293505841786,0.5086494887252255,203.52070000000003
45,2001-07-20,America's Sweethearts,46000000,93607673,160648493,114648493,0.7136605570274475,0.5085872928386971,203.49494130434783
4,2006-06-09,A Prairie Home Companion,10000000,20342852,26716191,16716191,0.6256951449403847,0.5084268420180219,203.42852
5,2007-02-23,Reno 911!: Miami,10000000,20342161,21851362,11851362,0.542362622522111,0.5084101438387003,203.42161000000002
21,2017-03-17,The Belko Experiment,5000000,10166820,11792942,6792942,0.5760175874688437,0.5082041385605331,203.33640000000003
76,2006-08-04,Talladega Nights: The Ballad of Ricky Bobby,73000000,148213377,162870525,89870525,0.5517912157525127,0.5074668597558505,203.03202328767122
98,2002-08-09,xXx,70000000,141930000,267200000,197200000,0.7380239520958084,0.5067991263298809,202.75714285714287
82,2004-07-30,Harold & Kumar Go to White Castle,9000000,18225165,18225165,9225165,0.5061773103288777,0.5061773103288777,202.5018333333333
51,2002-06-14,The Bourne Identity,60000000,121468960,214357371,154357371,0.7200936001403003,0.5060466476373882,202.44826666666665
91,2014-06-27,Begin Again,8000000,16170632,68838736,60838736,0.8837863612138375,0.5052759842657975,202.1329
20,2018-09-28,Hell Fest,5500000,11107431,18119231,12619231,0.6964551089392259,0.5048359967304771,201.95329090909092
79,2005-03-04,The Pacifier,56000000,113006880,198006880,142006880,0.7171815443988614,0.5044549499995045,201.798
48,2002-07-12,Halloween: Resurrection,15000000,30259652,37659652,22659652,0.6016957352659552,0.504290399638436,201.73101333333335
37,2007-05-17,Shrek the Third,160000000,322719944,807330936,647330936,0.8018160919328378,0.5042140934431991,201.699965
79,2008-04-25,Baby Mama,30000000,60494212,64170447,34170447,0.5324950751862457,0.5040847874834703,201.64737333333332
49,2007-12-25,The Great Debaters,15000000,30226144,30261293,15261293,0.5043172808247156,0.5037408675086045,201.50762666666665
50,2014-08-22,When the Game Stands Tall,15000000,30127963,30138912,15138912,0.5023045291084164,0.5021236583435793,200.85308666666668
99,2018-06-08,Oceanâs 8,70000000,140218711,297115976,227115976,0.7644017634379917,0.500779892349745,200.31244428571426
40,2007-01-26,Epic Movie,20000000,39739367,86858578,66858578,0.7697406466866173,0.49672072028726577,198.696835
17,2002-03-29,Panic Room,48000000,95308367,196308367,148308367,0.7554867337875619,0.49637160397470664,198.55909791666667
70,2013-03-01,21 and Over,13000000,25682380,42195766,29195766,0.6919122169745655,0.49381638306107145,197.55676923076925
7,2002-02-15,John Q,36000000,71026631,102226631,66226631,0.6478412753326479,0.4931478588643744,197.29619722222222
64,2011-11-23,The Muppets,45000000,88625922,160971922,115971922,0.7204481412603124,0.49224787754535293,196.94649333333334
44,2005-03-25,Guess Who,35000000,68915888,102115888,67115888,0.6572521604081826,0.4921345278174461,196.90253714285714
71,2007-11-21,The Mist,13000000,25593755,57189408,44189408,0.7726851797451724,0.4920635912940481,196.87503846153845
41,2008-09-19,Lakeview Terrace,20000000,39263506,44821299,24821299,0.5537835706189596,0.49062113811232244,196.31753
14,2014-08-01,Guardians of the Galaxy,170000000,333172112,770867516,600867516,0.7794692389139406,0.4897532119975276,195.98359529411763
5,2006-08-04,The Night Listener,4000000,7836393,10770993,6770993,0.6286321976070358,0.4895610773987471,195.909825
42,2006-10-13,The Grudge 2,20000000,39143839,70743839,50743839,0.7172898688746592,0.4890639111815272,195.71919499999998
81,2009-01-09,Bride Wars,30000000,58715510,115150424,85150424,0.7394712154946125,0.4890617487611025,195.71836666666667
72,2015-04-10,Ex Machina,13000000,25440971,38358392,25358392,0.6610911114313656,0.4890132141575886,195.6997769230769
5,2017-12-15,Star Wars Ep. VIII: The Last Jedi,317000000,620181382,1316721747,999721747,0.7592505776393166,0.4888592124811641,195.64081451104101
52,2004-02-20,Confessions of a Teenage Drama Queen,15000000,29331068,33118854,18118854,0.5470857777868763,0.48859686936732066,195.54045333333335
50,2018-06-15,Tag,28000000,54730625,77026186,49026186,0.6364872590212373,0.48840343043771195,195.46651785714286
1,2008-12-19,Yes Man,50000000,97690976,225990976,175990976,0.7787522276995698,0.48818199953289443,195.38195199999998
93,2011-09-23,Dolphin Tale,37000000,72286779,96068724,59068724,0.6148590461136967,0.48814983165870485,195.36967297297295
6,2002-10-18,Real Women Have Curves,3000000,5853194,7777790,4777790,0.6142863204072108,0.48745932562631616,195.10646666666668
49,2017-05-05,Guardians of the Galaxy Vol 2,200000000,389813101,862316233,662316233,0.7680665255434198,0.4869336112949164,194.9065505
30,2001-07-18,Jurassic Park III,93000000,181166115,365900000,272900000,0.7458321945886854,0.4866589704150801,194.80227419354839
92,2013-10-11,Captain Phillips,55000000,107136417,220648184,165648184,0.7507344089448749,0.4866358093718964,194.79348545454545
58,2007-07-11,Harry Potter and the Order of the Phoenix,150000000,292137260,943076457,793076457,0.8409460877889352,0.4865427299482442,194.75817333333333
59,2017-06-02,Captain Underpants: The First Epic Movie,38000000,73921000,126577874,88577874,0.6997895540574492,0.4859376902368745,194.52894736842106
37,2007-03-30,Blades of Glory,61000000,118594548,145594548,84594548,0.5810282676244168,0.48564245971914327,194.4172918032787
19,2005-06-17,Me and You and Everyone We Know,2000000,3885134,9615464,7615464,0.7920017172338225,0.48521724089825474,194.2567
19,2003-09-12,Once Upon a Time in Mexico,29000000,56330657,97413527,68413527,0.7023000717343906,0.4851826421978355,194.2436448275862
37,2009-01-16,Notorious,19000000,36843682,44972183,25972183,0.5775166173276489,0.48430778443913397,193.9141157894737
82,2004-08-20,Without a Paddle,30000000,58156435,65121280,35121280,0.5393210944256623,0.4841499483247211,193.85478333333333
45,2006-05-19,Over the Hedge,80000000,155019340,343397247,263397247,0.7670336594166115,0.4839353592912988,193.774175
59,2005-11-18,Harry Potter and the Goblet of Fire,150000000,290201752,897099794,747099794,0.8327945218544996,0.4831182135661262,193.46783466666665
22,2016-03-11,The Perfect Match,5000000,9669521,10182050,5182050,0.5089397518181505,0.48291130449998504,193.39042
45,2012-12-21,This is 40,35000000,67544505,90221182,55221182,0.6120644927928344,0.48182313276261335,192.9843
98,2008-08-22,The House Bunny,25000000,48237389,71390601,46390601,0.6498138459431095,0.48172982579965096,192.949556
43,2016-07-27,Nerve,20000000,38583626,70652284,50652284,0.7169235179997862,0.4816454005644778,192.91813
33,2005-05-27,The Longest Yard,82000000,158119460,191558505,109558505,0.5719323451600334,0.4814047556195803,192.82860975609756
39,2004-06-04,Harry Potter and the Prisoner of Azkaban,130000000,249757726,796907323,666907323,0.8368693620349628,0.47949558124980685,192.1213276923077
33,2013-04-26,Pain & Gain,26000000,49875291,81275291,55275291,0.680099576635167,0.47869978342582503,191.8280423076923
46,2012-09-07,The Words,6000000,11494838,16369708,10369708,0.6334693325012273,0.4780265715793472,191.58063333333334
66,2001-09-14,Hardball,21000000,40222729,43728560,22728560,0.5197646572400281,0.4779071305678936,191.53680476190476
36,2009-06-24,Transformers: Revenge of the Fallen,210000000,402111870,836519699,626519699,0.7489598867175034,0.4777572718756101,191.48184285714285
99,2017-07-07,Spider-Man: Homecoming,175000000,334201140,880166350,705166350,0.8011739485382507,0.47636324639706495,190.97208
54,2007-05-11,28 Weeks Later,15000000,28638916,64232714,49232714,0.7664741365280004,0.4762371592556087,190.92610666666667
27,2014-03-07,The Grand Budapest Hotel,31000000,59076019,163981261,132981261,0.8109540089461807,0.475252386251687,190.56780322580644
99,2003-03-14,Agent Cody Banks,25000000,47545060,58240458,33240458,0.5707451339067423,0.4741830171210216,190.18024
31,2011-08-05,Rise of the Planet of the Apes,93000000,176760185,470986200,377986200,0.802541985306576,0.4738634155649928,190.06471505376342
28,2015-07-29,Vacation,31000000,58884188,102306500,71306500,0.6969889498712203,0.4735428804758249,189.9489935483871
86,2001-02-09,Hannibal,87000000,165092266,350100280,263100280,0.7514997702943854,0.47302195246384227,189.76122528735632
94,2003-08-01,American Wedding,55000000,104354205,126425115,71425115,0.5649598578573569,0.47294888596008183,189.7349181818182
6,2015-09-25,The Intern,40000000,75764672,197115710,157115710,0.7970735057089057,0.472049453338886,189.41168
83,2011-05-20,Midnight in Paris,30000000,56816662,162502774,132502774,0.8153877668574444,0.4719858762558068,189.38887333333335
100,2006-01-27,Nanny McPhee,25000000,47279279,128745578,103745578,0.8058185734348097,0.47122713102287367,189.117116
8,2004-10-29,Ray,40000000,75305995,124823094,84823094,0.6795464787950217,0.4688337893948549,188.2649875
84,2017-11-22,Darkest Hour,30000000,56443120,150807172,120807172,0.801070468982735,0.46849146539029024,188.14373333333333
28,2006-07-07,Pirates of the Caribbean: Dead Manâs Chest,225000000,423315812,1066215812,841215812,0.7889733040274965,0.4684819380193622,188.1403608888889
93,2006-05-19,See No Evil,8000000,15032800,18828036,10828036,0.5751017259580341,0.46783034431376724,187.91
60,2003-05-15,The Matrix Reloaded,150000000,281553689,738576929,588576929,0.796906734951641,0.467241929833141,187.70245933333334
40,2017-04-07,Going in Style,24000000,45018541,78672579,54672579,0.694938181701149,0.4668863213492414,187.57725416666665
47,2006-10-13,Man of the Year,20000000,37442180,41342180,21342180,0.5162325740926096,0.4658430678982901,187.2109
60,2015-04-17,Paul Blart: Mall Cop 2,38000000,71091594,107650646,69650646,0.647006298503773,0.46547829550706094,187.08314210526316
51,2001-12-14,The Royal Tenenbaums,28000000,52353636,71430876,43430876,0.6080126470799546,0.46517563746670815,186.97727142857144
94,2018-02-23,Game Night,37000000,69179066,117378084,80378084,0.6847793153618013,0.46515612107281123,186.97044864864864
95,2017-11-10,Murder on the Orient Express,55000000,102826543,345922730,290922730,0.8410049550661214,0.4651186513194361,186.9573509090909
85,2005-10-05,Wallace & Gromit: The Curse of the Were-Rabbit,30000000,56068547,197593152,167593152,0.8481728759506807,0.464940655587169,186.89515666666668
50,2004-06-30,Spider-Man 2,200000000,373524485,795110670,595110670,0.748462688848082,0.46455986680498335,186.76224249999999
84,2015-01-30,Project Almanac,12000000,22348241,32909437,20909437,0.6353629507548245,0.46304498864138793,186.23534166666667
52,2003-04-25,Identity,28000000,52131264,82183683,54183683,0.6592997663538637,0.462894281634913,186.1830857142857
18,2015-01-09,Taken 3,48000000,89256424,327656424,279656424,0.8535050849483725,0.462223581800678,185.95088333333334
67,2015-04-03,Furious 7,190000000,353007020,1518722794,1328722794,0.8748948782815201,0.46176707760655866,185.79316842105263
100,2016-08-05,Suicide Squad,175000000,325100054,746059887,571059887,0.7654343799347035,0.4617041804613173,185.77145942857143
90,2013-07-26,Blue Jasmine,18000000,33404871,102912961,84912961,0.8250949168589172,0.4611564283544157,185.58261666666667
9,2005-04-01,Sin City,40000000,74103820,158527918,118527918,0.7476785130048829,0.4602167607553835,185.25955000000002
96,2014-09-26,The Equalizer,55000000,101530738,192903624,137903624,0.7148835316852317,0.4582921282419911,184.60134181818182
48,2016-02-19,Risen,20000000,36880033,46255763,26255763,0.5676214442727926,0.4577011360049488,184.40016500000002
8,2006-04-28,Water,3000000,5529144,11322573,8322573,0.7350425561398456,0.45742053381138204,184.3048
66,2005-05-13,Monster-in-Law,45000000,82931301,155931301,110931301,0.7114113733970577,0.45738220120289685,184.29178
7,2009-05-08,Star Trek,140000000,257730019,386839614,246839614,0.6380929074135618,0.45679591169393424,184.0928707142857
3,2018-10-05,Venom,116000000,213511408,853628605,737628605,0.8641095210252473,0.4567035031683178,184.06155862068965
15,2010-05-07,Iron Man 2,170000000,312433331,621156389,451156389,0.7263169098627753,0.4558839178397391,183.78431235294116
2,2014-02-28,Non-Stop,50000000,91742160,222383055,172383055,0.7751627254153874,0.45499430142041564,183.48432
49,2010-08-18,Vampires Suck,20000000,36661504,81424988,61424988,0.7543751556954483,0.4544686437304918,183.30751999999998
18,2001-12-28,I Am Sam,22000000,40270895,92542418,70542418,0.7622711781747479,0.4536997501545471,183.04952272727272
7,2015-10-23,Paranormal Activity: The Ghost Dimension,10000000,18297124,77959374,67959374,0.8717280618492396,0.4534660201242556,182.97124
38,2010-07-16,Inception,160000000,292576195,835524642,675524642,0.8085035533877167,0.4531339092710533,182.860121875
47,2005-07-29,Sky High,35000000,63939454,83109359,48109359,0.5788681272346234,0.4526071492571707,182.6841542857143
92,2002-10-04,Jonah: A VeggieTales Movie,14000000,25571351,25608779,11608779,0.45331247538197733,0.4525123056658211,182.65250714285713
8,2010-04-16,El secreto de sus ojos,3500000,6391436,40527719,37027719,0.9136393538456976,0.45239223235592124,182.61245714285715
97,2018-02-09,Fifty Shades Freed,55000000,100407760,371350619,316350619,0.8518919932108688,0.4522335723852419,182.55956363636363
26,2002-06-14,Scooby-Doo,84000000,153294164,276294164,192294164,0.6959762059976048,0.4520339339206677,182.4930523809524
93,2009-04-03,Fast & Furious,85000000,155064265,363064265,278064265,0.7658816683597324,0.45184017736130244,182.4285470588235
66,2012-12-19,Zero Dark Thirty,52500000,95720716,134612435,82112435,0.6099914543556099,0.45152938471542564,182.32517333333334
46,2002-06-21,Lilo & Stitch,80000000,145771527,245800000,165800000,0.6745321399511798,0.45119598013129136,182.21440875
93,2002-03-08,All About the Benjamins,14000000,25482931,25873145,11873145,0.45889840604997967,0.4506126473442164,182.0209357142857
52,2009-10-09,Couples Retreat,60000000,109205660,172450423,112450423,0.6520739180790528,0.4505779279205858,182.00943333333333
55,2002-10-25,Time Changer,825000,1500711,1500711,675711,0.4502605764867453,0.4502605764867453,181.90436363636366
94,2008-03-14,Horton Hears a Who,85000000,154529439,299477886,214477886,0.7161726993090902,0.44994299759284057,181.79934
57,2011-06-03,Beginners,3200000,5790894,14314407,11114407,0.7764489999480942,0.44740829308911545,180.9654375
10,2015-10-16,Bridge of Spies,40000000,72313754,162498338,122498338,0.7538436362346057,0.44685488185276623,180.78438500000001
64,2011-06-29,Transformers: Dark of the Moon,195000000,352390543,1123790543,928790543,0.8264801201481548,0.4466366823016587,180.71309897435896
11,2008-02-22,Vantage Point,40000000,72266306,150886329,110886329,0.7348997734579386,0.4464917025093271,180.665765
4,2013-08-09,Disney Planes,50000000,90282580,238059569,188059569,0.7899685351442438,0.44618330579387516,180.56516
19,2003-04-11,"House of 1,000 Corpses",7000000,12634962,17005466,10005466,0.5883676460262836,0.44598171328097386,180.49945714285712
95,2010-08-27,Takers,32000000,57744720,70587268,38587268,0.5466604544037602,0.4458367795358606,180.45225
85,2006-12-05,Black Christmas,9000000,16235738,16235738,7235738,0.44566732968960204,0.44566732968960204,180.39708888888887
34,2003-01-31,Final Destination 2,26000000,46896664,90396664,64396664,0.7123787665438627,0.4455895626179295,180.3717846153846
2,2014-08-15,The Giver,25000000,45090374,66540205,41540205,0.6242873011888076,0.44555793660083637,180.361496
49,2010-04-30,A Nightmare on Elm Street,35000000,63075011,117729621,82729621,0.7027086326898139,0.4451051304612535,180.21431714285714
57,2017-09-08,Home Again,15000000,27020284,37336874,22336874,0.5982523871709239,0.4448614973847055,180.13522666666665
12,2009-03-20,"I Love You, Man",40000000,72013010,92302502,52302502,0.5666422996854408,0.4445448121110338,180.032525
67,2001-07-27,Planet of the Apes,100000000,180011740,362211740,262211740,0.7239183909389574,0.44448067664920077,180.01174
67,2010-11-05,For Colored Girls,21000000,37729698,38017873,17017873,0.4476282247562876,0.4434092740418967,179.66522857142857
43,2001-06-27,Baby Boy,16000000,28734552,28734552,12734552,0.4431790688784708,0.44317906887847075,179.59095
20,2015-08-28,We Are Your Friends,2000000,3591417,10153415,8153415,0.8030219389239975,0.4431167419433611,179.57085
85,2010-05-14,Just Wright,12000000,21540363,21867665,9867665,0.4512445658921517,0.44290632428060756,179.50302499999998
53,2001-10-05,Serendipity,28000000,50255310,77477297,49477297,0.6386038093197804,0.44284494514112044,179.48325
99,2010-04-09,Date Night,55000000,98711404,152269033,97269033,0.6387972070460315,0.4428202034285724,179.47528
37,2008-06-27,Wanted,75000000,134508551,342416460,267416460,0.7809684733029482,0.4424146313196103,179.34473466666668
86,2007-12-21,P.S. I Love You,30000000,53695808,155769678,125769678,0.8074079603605523,0.44129716792789486,178.98602666666667
7,2007-12-28,El orfanato,4000000,7159147,79250193,75250193,0.9495269367987533,0.4412742188419933,178.978675
1,2009-12-18,Avatar,425000000,760507625,2776345279,2351345279,0.846921057256582,0.4411627365340354,178.94297058823528
84,2009-06-26,My Sister's Keeper,27500000,49200230,96673002,69173002,0.7155358845688893,0.44105952350222755,178.9099272727273
59,2017-03-03,Logan,127000000,226277068,615461394,488461394,0.7936507452163604,0.4387411807899155,178.17091968503937
76,2011-10-07,The Ides of March,23000000,40962534,77735925,54735925,0.7041265026434046,0.43851129913007825,178.09797391304346
51,2010-09-01,The American,20000000,35606376,67950723,47950723,0.705669062564647,0.4383028477820939,178.03188
82,2014-12-25,Unbroken,65000000,115637895,163527824,98527824,0.602514126281042,0.43790052560192316,177.90445384615384
87,2005-09-23,Corpse Bride,30000000,53359111,114770654,84770654,0.7386091395802274,0.4377717424864893,177.86370333333332
24,2004-05-28,Saved!,5000000,8886160,10206551,5206551,0.510118550331057,0.43732725946865686,177.7232
95,2014-03-21,Divergent,85000000,150947895,276014965,191014965,0.692045683102726,0.43689178308846244,177.5857588235294
36,2005-06-29,War of the Worlds,132000000,234280354,606836535,474836535,0.7824784890382382,0.4365724750441516,177.48511666666667
5,2006-03-10,Failure to Launch,50000000,88715192,128402901,78402901,0.6106006981882753,0.4363986722815186,177.430384
6,2006-03-24,Inside Man,50000000,88634237,185798265,135798265,0.7308909208597831,0.4358839011611281,177.268474
13,2001-11-09,Shallow Hal,40000000,70836296,70836296,30836296,0.43531773598100043,0.4353177359810005,177.09074
54,2003-05-30,The Italian Job,60000000,106126012,176262839,116262839,0.6595992647094491,0.4346343665490794,176.87668666666667
88,2018-05-11,Life of the Party,30000000,53059911,65759911,35759911,0.5437950030072273,0.4346013886076816,176.86637000000002
85,2005-07-08,Fantastic Four,87500000,154696080,333132750,245632750,0.7373419455157141,0.43437480768743464,176.79552
89,2010-05-14,Letters to Juliet,30000000,53032453,82148538,52148538,0.6348078647486094,0.4343086487061045,176.77484333333334
90,2001-04-06,Blow,30000000,52990775,83282296,53282296,0.6397793836039295,0.4338637243935383,176.63591666666667
9,2008-06-20,Kit Kittredge: An American Girl,10000000,17657973,17657973,7657973,0.4336835830477257,0.4336835830477258,176.57973
39,2015-11-20,The Hunger Games: Mockingjay - Part 2,160000000,281723902,648986787,488986787,0.753461852837383,0.43206806783472707,176.07743875
15,2006-01-27,Big Momma's House 2,40000000,70165972,137047376,97047376,0.7081301286644116,0.4299230971958886,175.41493
91,2006-04-28,United 93,18000000,31567134,77635035,59635035,0.7681459150498227,0.42978668890245153,175.37296666666666
53,2011-11-04,A Very Harold & Kumar 3D Christmas,20000000,35061031,36265745,16265745,0.4485153965539657,0.4295661185776311,175.30515499999998
94,2002-08-07,The Good Girl,8000000,14018296,16585503,8585503,0.5176510474237652,0.4293172294264581,175.2287
8,2007-05-25,Bug,4000000,7006708,8302995,4302995,0.518246126849408,0.4291184961611073,175.1677
82,2017-11-03,Thor: Ragnarok,180000000,315058289,846980024,666980024,0.7874802298761181,0.42867714869104745,175.03238277777777
40,2007-08-03,The Bourne Ultimatum,130000000,227471070,444043396,314043396,0.7072358216087511,0.4284987537096476,174.97774615384617
36,2004-12-29,In Good Company,26000000,45489752,63489752,37489752,0.5904850912002302,0.42844269628025233,174.96058461538462
92,2015-07-24,Southpaw,30000000,52421953,94156456,64156456,0.6813813807945363,0.4277206726731452,174.7398433333333
96,2012-09-28,Hotel Transylvania,85000000,148313048,378505812,293505812,0.7754327745963383,0.4268879161596086,174.4859388235294
60,2010-07-23,Ramona and Beezus,15000000,26167002,27469621,12469621,0.45394222949053425,0.4267589386051944,174.44668000000001
68,2007-01-05,Freedom Writers,21000000,36605602,43632609,22632609,0.5187085878820585,0.42631731613101187,174.31239047619047
54,2002-05-31,The Sum of All Fears,68000000,118471320,193500000,125500000,0.6485788113695091,0.426021420205329,174.2225294117647
65,2006-05-19,The Da Vinci Code,125000000,217536138,767820459,642820459,0.8372015247382202,0.42538282995536125,174.0289104
11,2005-09-23,Roll Bounce,10000000,17380866,17433072,7433072,0.42637763441807613,0.42465467485912384,173.80866
55,2003-05-09,Daddy Day Care,60000000,104148781,164285587,104285587,0.6347823257313497,0.4239010824332164,173.5813016666667
68,2004-11-19,National Treasure,100000000,173005002,331323410,231323410,0.6981800953938027,0.4219820303230308,173.005002
1,2009-08-21,Inglourious Basterds,70000000,120774594,316915264,246915264,0.7791207683830589,0.4204079046624657,172.53513428571426
7,2017-07-28,The Emoji Movie,50000000,86089513,216562312,166562312,0.7691195686902346,0.4192091666263695,172.179026
6,2015-11-20,The Night Before,25000000,43035725,52427346,27427346,0.5231496173771604,0.41908728155503366,172.1429
66,2003-05-02,X-Men 2,125000000,214949694,406875536,281875536,0.6927807426593473,0.4184685836305494,171.9597552
94,2017-07-28,Atomic Blonde,30000000,51573925,98345423,68345423,0.6949527585030572,0.4183107064277152,171.91308333333333
54,2004-03-19,Eternal Sunshine of the Spotless Mind,20000000,34366518,72570762,52570762,0.7244069174855846,0.4180382196415709,171.83258999999998
55,2013-01-04,Texas Chainsaw 3D,20000000,34341945,47666013,27666013,0.5804138265140825,0.417621803307879,171.709725
54,2010-04-16,Kick-Ass,28000000,48071303,97531134,69531134,0.7129121865844398,0.4175319108783051,171.683225
27,2011-04-01,Hop,63000000,108085305,188657593,125657593,0.6660616782066121,0.4171270553383737,171.56397619047618
56,2006-10-27,Babel,20000000,34302837,132121212,112121212,0.8486238530721322,0.41695784520679735,171.514185
57,2014-09-19,This is Where I Leave You,20000000,34296320,41296320,21296320,0.5156953452511023,0.4168470553108905,171.4816
95,2002-07-03,Like Mike,30000000,51432423,62432423,32432423,0.5194804468825437,0.4167103502006895,171.44141
76,2008-05-22,Indiana Jones and the Kingdom of the Crystal Skull,185000000,317101119,786635413,601635413,0.7648211649988353,0.41658988595369795,171.40601027027026
16,2018-09-21,The House with a Clock in its Walls,40000000,68549695,126331750,86331750,0.6833733404310476,0.41648172176404286,171.3742375
74,2008-05-02,Iron Man,186000000,318604126,585171547,399171547,0.6821444908701279,0.41620341727777876,171.29254086021507
74,2001-09-07,Two Can Play That Game,13000000,22235901,22391450,9391450,0.4194212523083588,0.41535987230740057,171.0453923076923
52,2006-04-07,The Benchwarmers,35000000,59843754,65063726,30063726,0.46206585217698726,0.4151436422253858,170.98215428571427
96,2011-04-01,Source Code,32000000,54712227,140428499,108428499,0.7721260269256314,0.4151215961287776,170.975709375
61,2007-12-14,I am Legend,150000000,256393010,585532684,435532684,0.743823010911548,0.41496064966825735,170.92867333333334
100,2002-12-13,Maid in Manhattan,55000000,93932896,163838217,108838217,0.6643029873793121,0.4144756273670089,170.78708363636363
53,2010-10-08,Secretariat,35000000,59699513,60376247,25376247,0.42030182830012597,0.413730560917641,170.57003714285713
83,2015-06-05,Spy!,65000000,110825712,232585748,167585748,0.7205331772951111,0.41349350410670044,170.50109538461538
97,2007-12-07,Atonement,30000000,50980159,129779728,99779728,0.7688390901851789,0.41153577021993987,169.93386333333333
14,2012-07-13,Ice Age: Continental Drift,95000000,161321843,879765137,784765137,0.892016634889682,0.41111508377696876,169.8124663157895
24,2001-06-15,Songcatcher,1800000,3050934,3050934,1250934,0.4100167358585928,0.41001673585859283,169.49633333333333
67,2001-10-05,Training Day,45000000,76261036,104505362,59505362,0.5694000849449237,0.409921470251204,169.4689688888889
18,2005-06-10,Mr. and Mrs. Smith,110000000,186336279,486124090,376124090,0.7737203272522454,0.4096694396264079,169.39661727272727
44,2001-04-11,Joe Dirt,16000000,27087695,30987695,14987695,0.483666016462341,0.4093258950235522,169.29809375
25,2003-05-09,Les invasions barbares,5000000,8460000,25913869,20913869,0.807053126648128,0.408983451536643,169.2
21,2003-06-06,Mambo Italiano,5500000,9282750,12399772,6899772,0.5564434571861483,0.40750316447173524,168.77727272727273
8,2011-07-29,"Crazy, Stupid, Love",50000000,84351197,147142328,97142328,0.6601929527715505,0.4072401841553001,168.702394
19,2002-12-19,Antwone Fisher,12500000,21078145,23367586,10867586,0.46507097481100523,0.4069686872350484,168.62516
92,2003-12-05,Honey,18000000,30272254,62646763,44646763,0.7126746995690741,0.40539610958602557,168.1791888888889
45,2008-09-12,The Women,16000000,26902075,50103808,34103808,0.6806629947168886,0.4052503384961941,168.13796875
67,2011-04-29,Fast Five,125000000,210031325,630163454,505163454,0.8016387665667454,0.40485068120195883,168.02506
17,2016-11-04,Hacksaw Ridge,40000000,67209615,168904682,128904682,0.7631800402075296,0.40484705945719224,168.0240375
72,2004-08-06,Saints and Soldiers,780000,1310470,1310470,530470,0.4047936999702397,0.4047936999702397,168.00897435897434
48,2006-06-28,Who Killed the Electric Car?,1000000,1678874,1849392,849392,0.45928175313832864,0.4043626859430785,167.88739999999999
59,2009-10-09,An Education,7500000,12574914,29652736,22152736,0.747072243181877,0.4035744498928581,167.66552
68,2016-10-07,The Girl on the Train,45000000,75395035,174278214,129278214,0.7417921668625777,0.4031437215991743,167.5445222222222
1,2009-05-29,Up,175000000,293004164,731463377,556463377,0.7607535722188317,0.40273886346543525,167.43095085714285
23,2003-06-06,2 Fast 2 Furious,76000000,127120058,236410607,160410607,0.678525422507798,0.40213998329044187,167.26323421052632
58,2008-12-12,Doubt,20000000,33446470,53191101,33191101,0.6239972547287562,0.402029571431604,167.23235
90,2013-01-11,Quartet,11000000,18388357,56178935,45178935,0.8041970713755966,0.40179538606956566,167.16688181818182
29,2007-11-30,Awake,8600000,14373825,32968648,24368648,0.7391461123913846,0.4016902251140528,167.13750000000002
51,2010-03-05,Alice in Wonderland,200000000,334191110,1025491110,825491110,0.8049714931219637,0.4015400349817803,167.095555
48,2013-07-12,Grown Ups 2,80000000,133668525,247023808,167023808,0.6761445763154943,0.40150458007971584,167.08565625
18,2001-03-02,The Mexican,40000000,66808615,145238250,105238250,0.7245904574036109,0.40127482062006525,167.0215375
47,2016-01-15,The Lady in the Van,6000000,10021175,42320503,36320503,0.8582247474705109,0.40126781540088863,167.01958333333334
4,2003-08-08,S.W.A.T.,70000000,116877597,207154748,137154748,0.6620883630434578,0.4010828268483309,166.9679957142857
58,2004-08-06,Collateral,60000000,100170152,217670152,157670152,0.7243535714533796,0.4010191778485072,166.95025333333334
38,2018-11-02,Nobodyâs Fool,19000000,31713110,32589493,13589493,0.41699000963285926,0.4008786902325253,166.91110526315788
21,2006-11-10,Harsh Times,2000000,3337931,6225304,4225304,0.6787305487410735,0.40082644009118223,166.89655000000002
61,2014-08-27,The November Man,15000000,25018119,34820335,19820335,0.5692172404429768,0.40043454106201987,166.78746
8,2002-12-27,The Hours,25000000,41675994,97030468,72030468,0.7423489702224253,0.4001342835398239,166.703976
41,2018-07-06,Ant-Man and the Wasp,130000000,216648740,623144660,493144660,0.7913807044418866,0.39995035281534524,166.65287692307692
29,2006-06-23,Click,82500000,137355633,237685089,155185089,0.6529020800290926,0.3993693727872085,166.49167636363634
49,2011-12-16,Alvin and the Chipmunks: Chipwrecked,80000000,133107389,349088523,269088523,0.7708317669326528,0.39898152460942643,166.38423625000001
19,2009-08-28,The Final Destination,40000000,66477700,187384627,147384627,0.7865353170086893,0.39829446566292154,166.19425
99,2005-01-14,Racing Stripes,30000000,49772522,89955540,59955540,0.6665019186144622,0.39725778814262214,165.90840666666665
62,2016-11-23,Moana,150000000,248757044,637517365,487517365,0.7647122914055839,0.397002000072006,165.83802933333334
42,2008-06-06,Kung Fu Panda,130000000,215434591,631910531,501910531,0.7942746739886187,0.3965685854041889,165.71891615384615
44,2007-11-21,Hitman,24000000,39687694,99135571,75135571,0.7579072803242339,0.3952785465439237,165.36539166666665
14,2005-06-17,The Perfect Man,10000000,16535005,19535005,9535005,0.48809841615090444,0.39522243869899043,165.35005
97,2019-04-05,Shazam!,85000000,139606856,362899733,277899733,0.7657755234556758,0.3911473803263645,164.24336
60,2006-11-17,Casino Royale,102000000,167365000,594420283,492420283,0.8284042403714544,0.3905535804977146,164.08333333333334
93,2005-10-14,The Fog,18000000,29511112,37048526,19048526,0.5141507114210158,0.39006025933553434,163.95062222222222
87,2011-03-04,Beastly,17000000,27865571,38028230,21028230,0.5529636798767652,0.3899281661947641,163.91512352941174
59,2004-10-15,Team America: World Police,20000000,32774834,50948811,30948811,0.6074491316392054,0.3897757041271361,163.87417
9,2017-12-22,The Post,50000000,81903458,179748880,129748880,0.7218341499540916,0.3895251651035296,163.806916
19,2005-11-11,Derailed,22000000,36020063,57520063,35520063,0.6175247582743434,0.38922927480720954,163.72755909090907
50,2009-04-03,Adventureland,9800000,16044025,17553055,7753055,0.4416926284341957,0.3891807074596306,163.71454081632652
97,2008-08-06,The Sisterhood of the Traveling Pants 2,27000000,44089964,44270131,17270131,0.3901079714446745,0.3876157394911912,163.29616296296297
17,2016-05-06,Captain America: Civil War,250000000,408084349,1140069413,890069413,0.7807151063353719,0.387381553317057,163.2337396
9,2002-10-11,The Rules of Attraction,4000000,6525762,11799060,7799060,0.6609899432666669,0.3870447619756896,163.14405
95,2008-09-12,Burn After Reading,37000000,60355347,168167798,131167798,0.7799816585574844,0.3869640083421275,163.12255945945947
2,2005-09-23,Flightplan,55000000,89706988,214392904,159392904,0.7434616586004171,0.38689280259861136,163.10361454545455
92,2001-09-07,L.I.E.,700000,1140965,1140965,440965,0.386484247983067,0.38648424798306696,162.995
11,2012-07-20,The Dark Knight Rises,275000000,448139099,1084439099,809439099,0.7464126844434259,0.3863512453752668,162.95967236363634
50,2008-06-20,Get Smart,80000000,130319208,226739416,146739416,0.6471720646929778,0.3861227272038056,162.89901
69,2012-12-25,Django Unchained,100000000,162805434,449948323,349948323,0.7777522553406649,0.3857698877544837,162.805434
45,2009-08-14,The Time Traveler's Wife,39000000,63414846,102332135,63332135,0.6188880452850906,0.3850020545662131,162.60216923076922
54,2010-10-15,N-Secure,1600000,2595644,2595644,995644,0.38358264846797174,0.38358264846797174,162.22775000000001
83,2005-12-09,"The Chronicles of Narnia: The Lion, the Witch and the Wardrobe",180000000,291710957,720539572,540539572,0.7501872110918566,0.3829508433582767,162.06164277777776
66,2001-06-13,Sexy Beast,4300000,6946056,10158355,5858355,0.5767031177784199,0.38094366069032554,161.53618604651163
55,2001-09-28,Zoolander,28000000,45172250,60780981,32780981,0.5393295807450031,0.3801504242095534,161.3294642857143
39,2004-02-13,50 First Dates,75000000,120776832,196320329,121320329,0.6179713003639068,0.3790199762815438,161.035776
10,2007-12-26,There Will Be Blood,25000000,40222514,77208711,52208711,0.6762023393966516,0.3784575474322664,160.890056
78,2013-02-01,The Gatekeepers,1500000,2408553,2592308,1092308,0.4213650538439106,0.37721943424122284,160.5702
11,2002-12-20,The Wild Thornberrys Movie,25000000,40108697,60694737,35694737,0.5881026719005307,0.3766937878834608,160.434788
20,2009-04-17,17 Again,40000000,64167069,139474906,99474906,0.7132100594496904,0.3766272852512556,160.4176725
86,2016-11-18,The Edge of Seventeen,9000000,14431633,19096003,10096003,0.5286971833843972,0.3763699506493825,160.35147777777777
16,2002-01-25,Kung Pow: Enter the Fist,10000000,16033556,17033556,7033556,0.41292352577465324,0.37630803796737294,160.33556
51,2005-03-11,Robots,80000000,128200012,260700012,180700012,0.6931338844740828,0.3759750974126274,160.250015
42,2007-03-09,The Namesake,8500000,13610521,20288774,11788774,0.5810491062693093,0.37548312808892476,160.12377647058824
61,2013-04-12,Scary Movie V,20000000,32015787,78613981,58613981,0.7455923266371665,0.37530818780122444,160.078935
62,2010-03-12,She's Out of My League,20000000,32010860,48680977,28680977,0.5891619019889432,0.37521203741480236,160.0543
52,2010-02-19,Shutter Island,80000000,128012934,299461782,219461782,0.7328540574837025,0.37506314791597545,160.0161675
12,2009-03-20,Knowing,50000000,79957634,186450317,136450317,0.7318320461745312,0.37466884025107594,159.915268
88,2010-03-05,Brooklyn's Finest,17000000,27163593,39233233,22233233,0.5666938791406765,0.37416232086822976,159.7858411764706
46,2011-04-15,Rio,90000000,143619809,487519809,397519809,0.8153921167129436,0.3733454972078399,159.57756555555557
55,2011-07-22,Friends with Benefits,35000000,55802754,146595891,111595891,0.7612484240775889,0.37279081243911366,159.43644
90,2004-07-30,The Village,71682975,114197520,257641634,185958659,0.7217725493853994,0.37228956460700724,159.30912465616836
21,2011-02-18,Unknown,40000000,63686397,136123083,96123083,0.7061482952160288,0.3719223902711909,159.2159925
63,2008-11-26,Milk,20000000,31841299,57293371,37293371,0.6509194754834726,0.3718849221572273,159.206495
62,2016-12-23,Why Him?,38000000,60323786,117425156,79425156,0.676389614504749,0.37006606316122137,158.7468052631579
17,2016-10-07,The Birth of a Nation,10000000,15861566,16891011,6891011,0.4079691263003737,0.3695452264927687,158.61566
40,2007-07-20,Hairspray,75000000,118871849,203035572,128035572,0.6306066012905365,0.36906844950312834,158.49579866666667
70,2001-07-04,Scary Movie 2,45000000,71277420,141189101,96189101,0.6812785145504964,0.36866401730028947,158.39426666666668
95,2006-08-04,"Bon Cop, Bad Cop",8000000,12671300,12740705,4740705,0.37209126182577806,0.36865199308673935,158.39125
56,2016-05-20,Neighbors 2: Sorority Rising,35000000,55340730,108757621,73757621,0.6781834718506761,0.36755442149028394,158.11637142857143
12,2003-06-13,Rugrats Go Wild,25000000,39402572,55443032,30443032,0.5490867093992984,0.3655236516032507,157.610288
37,2011-10-21,Margin Call,3400000,5353586,20433227,17033227,0.8336043543195601,0.36491166855262996,157.4584117647059
30,2019-02-13,Isnât it Romantic,31000000,48791187,48791187,17791187,0.36463935587383844,0.36463935587383844,157.39092580645163
41,2013-05-31,Now You See Me,75000000,117723989,342769200,267769200,0.7811938762292528,0.36291659298089196,156.9653186666667
84,2001-06-22,Dr. Dolittle 2,72000000,112950721,176101721,104101721,0.591145392610899,0.3625538698420526,156.87600138888888
72,2001-03-16,Exit Wounds,33000000,51758599,79958599,46958599,0.587286415561133,0.36242478278826673,156.84423939393938
89,2005-03-11,The Upside of Anger,12000000,18761993,28915761,16915761,0.5850014115139491,0.3604090993957838,156.34994166666667
100,2015-09-18,Sicario,30000000,46889293,84393749,54393749,0.6445234350236059,0.3601950876077402,156.29764333333333
13,2005-06-01,The Sisterhood of the Traveling Pants,25000000,39053061,41560117,16560117,0.398461751202481,0.35984531404593356,156.212244
5,2008-07-25,Man on Wire,1900000,2962242,5617067,3717067,0.6617451776879286,0.3585939298679851,155.90747368421052
65,2011-08-31,The Debt,20000000,31177548,46604054,26604054,0.5708527846096823,0.3585127348693361,155.88774
53,2003-12-12,Something's Gotta Give,80000000,124685242,266685242,186685242,0.7000208957944511,0.3583843707822294,155.8565525
59,2001-07-04,Cats & Dogs,60000000,93375151,200700000,140700000,0.7010463378176383,0.3574307579968465,155.62525166666668
60,2002-12-20,Two Weeks Notice,60000000,93354918,199043309,139043309,0.6985580660739518,0.35729149266672805,155.59152999999998
87,2016-12-02,Jackie,9000000,13960394,36588512,27588512,0.754021152868966,0.3553190547487413,155.11548888888888
90,2006-03-03,Aquamarine,12000000,18597342,22978953,10978953,0.47778299559601345,0.3547465008709309,154.97785
57,2007-03-23,TMNT,35000000,54149098,96096018,61096018,0.635780954003734,0.3536365093283733,154.71170857142857
84,2010-11-05,Due Date,65000000,100539043,211739043,146739043,0.6930183537289342,0.3534849938844156,154.67545076923076
85,2008-07-25,Step Brothers,65000000,100468793,128468793,63468793,0.4940405488202881,0.3530329363068988,154.56737384615386
63,2011-04-22,Water for Elephants,38000000,58709717,116809717,78809717,0.6746845983712126,0.3527476891091129,154.4992552631579
37,2010-01-22,Legion,26000000,40168080,67647574,41647574,0.6156551009501094,0.35271987110163094,154.4926153846154
96,2004-04-23,13 Going On 30,37000000,57139723,97658712,60658712,0.6211295516574087,0.3524644842958024,154.43168378378377
85,2008-02-08,Welcome Home Roscoe Jenkins,27500000,42436517,43607627,16107627,0.3693763707894493,0.3519732074147367,154.31460727272727
18,2003-05-30,Wrong Turn,10000000,15417771,28649556,18649556,0.6509544510916679,0.351397812303737,154.17771
57,2007-07-27,No Reservations,28000000,43107979,91943956,63943956,0.6954666601467528,0.35046827409839837,153.95706785714285
63,2005-12-28,Match Point,15000000,23089926,87973835,72973835,0.8294947582994421,0.35036604274955235,153.93284
13,2013-09-27,Cloudy with a Chance of Meatballs 2,78000000,119793567,274392649,196392649,0.7157358249783142,0.3488798943602706,153.58149615384616
48,2012-04-27,Bernie,6000000,9204489,10106975,4106975,0.40635056483270227,0.3481441500989354,153.40815
68,2014-08-08,Teenage Mutant Ninja Turtles,125000000,191204754,485004754,360004754,0.7422705675169525,0.34625056446033764,152.9638032
14,2002-05-31,Undercover Brother,25000000,38230435,40796145,15796145,0.387197001089196,0.3460707418055798,152.92174
22,2010-06-04,Get Him to the Greek,40000000,61153526,91455875,51455875,0.5626306128501859,0.3459085253726825,152.883815
16,2014-04-04,Captain America: The Winter Soldier,170000000,259746958,714401889,544401889,0.7620387031199466,0.3455168780070949,152.79232823529412
99,2018-04-20,I Feel Pretty,32000000,48795601,91553797,59553797,0.6504787234548011,0.34420317929888805,152.486253125
52,2012-11-08,Skyfall,200000000,304360277,1110526981,910526981,0.8199053211477083,0.34288402556553066,152.1801385
63,2008-07-01,Hancock,150000000,227946274,624234272,474234272,0.7597055997591879,0.34195020007214505,151.96418266666666
98,2016-05-13,Money Monster,27000000,41012075,93466095,66466095,0.7111251946494609,0.34165730458651505,151.89657407407407
13,2005-03-18,The Ring Two,50000000,75941727,161941727,111941727,0.6912469631745992,0.3416004352916546,151.883454
57,2005-08-05,The Dukes of Hazzard,53000000,80270227,109848461,56848461,0.5175171366306169,0.3397302838074695,151.45325849056604
20,2009-09-18,The Informant!,22000000,33316821,41771168,19771168,0.47332092796639064,0.3396728937613826,151.44009545454546
50,2002-03-22,Blade 2,54000000,81676888,154338601,100338601,0.650119933379466,0.3388582581647822,151.2534962962963
14,2011-12-23,We Bought a Zoo,50000000,75624550,118729073,68729073,0.5788731543452714,0.3388390410256987,151.2491
21,2009-08-14,"The Goods: Live Hard, Sell Hard",10000000,15122676,15297318,5297318,0.34629063735224697,0.33874137090551965,151.22675999999998
15,2011-09-23,Moneyball,50000000,75605492,111300835,61300835,0.5507670719631169,0.33867238110162684,151.210984
99,2002-05-17,About a Boy,27000000,40803000,130759651,103759651,0.7935142852285526,0.3382839497095802,151.12222222222223
62,2002-04-19,The Scorpion King,60000000,90580000,165890634,105890634,0.6383159280710206,0.33760211967321707,150.96666666666667
15,2013-12-25,August: Osage County,25000000,37738810,50738810,25738810,0.507280521557364,0.33755197898396905,150.95524
16,2004-06-11,Garfield: The Movie,50000000,75367693,208094550,158094550,0.7597246059543606,0.3365857702450837,150.735386
63,2010-10-15,Red,60000000,90380162,196439693,136439693,0.6945627480694546,0.3361375032720123,150.63360333333333
66,2002-10-25,Ghost Ship,20000000,30113491,68349884,48349884,0.707387945237771,0.33584585061891364,150.567455
67,2010-01-08,Daybreakers,20000000,30101577,51445503,31445503,0.6112391009181114,0.3355829829114933,150.50788500000002
68,2008-03-07,The Bank Job,20000000,30060660,66143005,46143005,0.6976248660005695,0.3346786131774884,150.3033
98,2007-11-21,Enchanted,85000000,127706877,340384141,255384141,0.7502821378508348,0.3344132908363267,150.24338470588233
54,2008-11-26,Four Christmases,80000000,120146040,168311558,88311558,0.5246909900269594,0.33414368047419624,150.18255
3,2018-01-19,Den of Thieves,30000000,44947622,80131391,50131391,0.625614885432352,0.3325564587154355,149.82540666666665
58,2003-10-24,Radio,35000000,52333738,53293628,18293628,0.3432610742882808,0.33121536244936295,149.5249657142857
69,2011-12-16,Sherlock Holmes: A Game of Shadows,125000000,186848418,535663443,410663443,0.7666445197381148,0.33100851835951856,149.47873439999998
72,2005-01-14,Coach Carter,45000000,67264877,76665507,31665507,0.41303459977118523,0.3310030136530243,149.47750444444446
70,2004-05-28,The Day After Tomorrow,125000000,186740799,556319450,431319450,0.7753089524373091,0.3306229775743864,149.39263920000002
97,2012-06-08,Madagascar 3: Europe's Most Wanted,145000000,216391482,746921271,601921271,0.805869767497892,0.32991817117829064,149.2355048275862
40,2013-05-24,Fast and Furious 6,160000000,238679850,789300444,629300444,0.7972888508852783,0.3296459671815614,149.17490625
95,2015-08-07,Ricki and the Flash,18000000,26839498,41166033,23166033,0.5627463059168223,0.329346621907757,149.1083222222222
73,2010-03-19,The Bounty Hunter,45000000,67061228,135808837,90808837,0.6686519007595949,0.3289714289156769,149.0249511111111
23,2003-11-21,Gothika,40000000,59588068,141484812,101484812,0.7172841421311003,0.328724670180614,148.97017
5,2017-11-10,Daddyâs Home 2,70000000,104029443,175807183,105807183,0.6018365188184603,0.32711357495204507,148.61348999999998
99,2012-02-10,Safe House,85000000,126181630,208542162,123542162,0.5924085605288776,0.3263678714564077,148.44897647058824
70,2010-12-22,Little Fockers,100000000,148438600,310650574,210650574,0.6780949131611778,0.3263207817912592,148.4386
74,2002-04-12,Changing Lanes,45000000,66790248,66790248,21790248,0.32624894580418384,0.32624894580418384,148.42277333333334
4,2012-04-13,The Three Stooges,30000000,44338224,54052249,24052249,0.44498146598858457,0.323382912224901,147.79408
46,2007-04-20,Hot Fuzz,16000000,23618786,81742618,65742618,0.8042636706350658,0.3225731415662092,147.6174125
43,2013-10-04,Grace Unplugged,1700000,2507159,2507159,807159,0.32194168778286497,0.32194168778286497,147.4799411764706
17,2004-11-24,Christmas with the Kranks,50000000,73701902,96469187,46469187,0.48169978876260244,0.32159145635074654,147.40380399999998
16,2001-07-06,Kiss of the Dragon,25000000,36833473,36833473,11833473,0.3212695419734109,0.32126954197341095,147.333892
77,2016-05-20,The Angry Birds Movie,73000000,107509366,352327887,279327887,0.7928066363932186,0.32098939175215674,147.27310410958904
9,2016-07-22,Donât Think Twice,3000000,4417983,4417983,1417983,0.3209570973903702,0.3209570973903702,147.2661
48,2012-08-31,"For a Good Time, Call",850000,1251749,1386088,536088,0.38676332238645744,0.32095012658288524,147.26458823529413
3,2014-05-02,Ida,2600000,3827060,15298355,12698355,0.8300470867619427,0.3206273222787205,147.1946153846154
24,2001-11-30,Behind Enemy Lines,40000000,58855732,58855732,18855732,0.32037205823894943,0.32037205823894943,147.13933
91,2013-11-15,Nebraska,12000000,17654912,24761360,12761360,0.5153739536115949,0.3203024744614983,147.12426666666667
47,2006-10-06,The Departed,90000000,132384315,289660619,199660619,0.6892915567511095,0.32016115353242564,147.09368333333333
64,2004-03-05,Starsky & Hutch,60000000,88200225,170200225,110200225,0.6474740265472622,0.31972962654006837,147.00037500000002
69,2017-08-04,Kidnap,21000000,30718107,34836080,13836080,0.3971767202279935,0.31636412360957006,146.2767
47,2002-05-24,Insomnia,46000000,67263182,113622499,67622499,0.5951506048111123,0.3161191809212951,146.22430869565218
98,2015-11-13,Love the Coopers,18000000,26302731,42227490,24227490,0.573737392395333,0.3156604156427711,146.12628333333333
39,2010-08-20,The Switch,19000000,27758465,49858465,30858465,0.6189212804686225,0.315524111293618,146.0971842105263
22,2011-11-23,My Week with Marilyn,10000000,14597405,34240572,24240572,0.7079488041262862,0.3149467319705112,145.97405
17,2014-05-16,Million Dollar Arm,25000000,36447959,39217912,14217912,0.3625361798965738,0.3140905365921861,145.79183600000002
21,2003-10-10,House of the Dead,7000000,10199354,13860078,6860078,0.49495233720906917,0.3136820233908932,145.70505714285716
90,2010-08-20,Lottery Ticket,17000000,24719879,24719879,7719879,0.31229436843117236,0.31229436843117236,145.41105294117648
18,2004-01-01,Beauty Shop,25000000,36351350,38351350,13351350,0.34813246469811365,0.31226763242630606,145.4054
70,2009-10-16,The Stepfather,20000000,29062561,29227561,9227561,0.3157143697347856,0.31182940140753596,145.312805
93,2017-08-04,Columbus,700000,1017107,1110511,410511,0.3696595531246426,0.31177349089132217,145.301
47,2008-08-15,Vicky Cristina Barcelona,16000000,23216709,104504817,88504817,0.846897009541675,0.310841170469079,145.10443125
25,2011-03-18,The Lincoln Lawyer,40000000,58009200,87145086,47145086,0.5409953465419726,0.31045420381594646,145.023
23,2014-12-25,Big Eyes,10000000,14482031,27317872,17317872,0.6339392760900263,0.30948911792827954,144.82031
26,2004-10-15,Shall We Dance?,40000000,57887882,118097882,78097882,0.6612979054103613,0.3090090945113521,144.719705
27,2010-05-21,Shrek Forever After,165000000,238736787,756244673,591244673,0.7818166449418413,0.3088622743339509,144.68896181818184
95,2010-03-12,Our Family Wedding,14000000,20255281,21410546,7410546,0.3461166286931683,0.308822227645225,144.68057857142858
27,2006-08-25,Invincible,40000000,57806952,58501127,18501127,0.31625248860590327,0.3080417040497136,144.51738
98,2011-12-16,Mission: ImpossibleâGhost Protocol,145000000,209397903,694713230,549713230,0.7912807850226199,0.30753843318096646,144.41234689655172
92,2004-01-09,My Baby's Daddy,12000000,17321573,17322212,5322212,0.3072478272405395,0.30722227132605107,144.34644166666666
60,2009-09-04,Extract,7500000,10823158,10849158,3349158,0.30870211310407686,0.30704143836761877,144.30877333333333
93,2001-10-05,Max Keeble's Big Move,12000000,17292381,17292381,5292381,0.30605276393112085,0.30605276393112085,144.103175
19,2003-04-04,What a Girl Wants,25000000,35990505,35990505,10990505,0.30537234751221193,0.30537234751221193,143.96202
75,2016-03-11,Eye in the Sky,13000000,18704596,35402802,22402802,0.6327974265991715,0.30498365214624257,143.8815076923077
38,2012-08-29,Lawless,26000000,37397291,54393687,28393687,0.5220033530729402,0.3047624759772038,143.8357346153846
7,2001-12-14,Vanilla Sky,70000000,100614858,202726605,132726605,0.6547073828814919,0.3042777041935496,143.73551142857144
6,2014-10-24,John Wick,30000000,43037835,76235001,46235001,0.6064799684333971,0.30293891409732854,143.45945
59,2018-06-29,Sicario: Day of the Soldado,35000000,50065850,75885196,40885196,0.5387769704119891,0.30092068745462225,143.0452857142857
49,2009-07-10,BrÃ¼no,42000000,60054530,138708527,96708527,0.6972067910432067,0.3006356056737102,142.9869761904762
100,2011-08-19,Spy Kids: All the Time in the World,27000000,38536376,80681183,53681183,0.6653494780809052,0.2993632821103884,142.72731851851853
78,2006-08-04,Barnyard: The Original Party Animals,51000000,72779000,118583844,67583844,0.5699245505989838,0.29924840956869425,142.70392156862746
67,2013-03-29,The Place Beyond the Pines,15000000,21403519,47011449,32011449,0.6809287882192272,0.2991806627685849,142.69012666666669
28,2013-02-15,Escape From Planet Earth,40000000,57012977,74156610,34156610,0.4606010172255716,0.29840534375182687,142.5324425
20,2003-08-29,Jeepers Creepers II,25000000,35623801,119923801,94923801,0.7915342926797325,0.2982219948960528,142.495204
39,2002-03-29,Clockstoppers,26000000,36985501,38788828,12788828,0.32970390340228894,0.2970218248496891,142.25192692307692
7,2006-01-13,Glory Road,30000000,42647449,42799060,12799060,0.299050025865054,0.29655815990306944,142.15816333333333
8,2015-04-24,The Age of Adaline,30000000,42629776,68984536,38984536,0.5651199277472853,0.29626653445235085,142.09925333333334
21,2018-09-07,Peppermint,25000000,35418723,51800758,26800758,0.5173815796286224,0.29415862903922313,141.674892
60,2009-11-25,Old Dogs,35000000,49492060,95104304,60104304,0.6319830067837939,0.29281585773556407,141.40588571428572
9,2010-08-06,Step Up 3D,30000000,42400223,165889117,135889117,0.8191563102961118,0.2924565514667222,141.33407666666668
9,2013-03-22,Olympus Has Fallen,70000000,98927592,172878928,102878928,0.5950923527244454,0.292411767184225,141.32513142857144
19,2015-05-29,San Andreas,110000000,155190832,456258539,346258539,0.7589086217628028,0.29119524277052655,141.08257454545455
18,2006-03-17,V for Vendetta,50000000,70511035,130214162,80214162,0.6160171886680037,0.29089113498333985,141.02206999999999
28,2016-11-04,Doctor Strange,165000000,232641920,676404566,511404566,0.7560631487517191,0.2907555095831396,140.99510303030303
100,2007-07-20,I Now Pronounce You Chuck and Larry,85000000,119725280,185708462,100708462,0.5422933393309778,0.29004133462874343,140.8532705882353
64,2010-10-08,Life as We Know It,38000000,53374681,105887837,67887837,0.6411296983996376,0.2880519510739558,140.45968684210527
51,2006-07-14,"You, Me and Dupree",54000000,75802010,130402010,76402010,0.5858959535976478,0.2876178349360393,140.3740925925926
10,2016-06-24,Swiss Army Man,3000000,4210454,5837111,2837111,0.4860471215983386,0.28748776260232267,140.34846666666667
20,2018-11-16,Instant Family,48000000,67363237,119736188,71736188,0.5991186891635468,0.287445168349021,140.34007708333334
10,2009-05-29,Drag Me To Hell,30000000,42100625,91388487,61388487,0.6717310792113235,0.28742150502516295,140.33541666666667
11,2012-04-13,The Cabin in the Woods,30000000,42073277,70689968,40689968,0.5756116341713438,0.2869583227377321,140.24425666666667
12,2003-09-19,Secondhand Lions,30000000,42070939,47902566,17902566,0.373728747641619,0.28691869701315675,140.23646333333332
22,2007-09-21,Good Luck Chuck,25000000,35017297,59183821,34183821,0.5775872598695512,0.2860671113478576,140.069188
71,2017-03-31,The Boss Baby,125000000,175003033,510878762,385878762,0.7553235536536161,0.28572666509157013,140.0024264
68,2006-10-20,Flicka,15000000,21000147,21896367,6896367,0.31495485072934704,0.28571928567928595,140.00098
71,2019-05-31,Rocketman,41000000,57342725,108642725,67642725,0.6226162405259993,0.2850008436118095,139.8603048780488
87,2003-07-25,Seabiscuit,86000000,120277854,148715342,62715342,0.42171400177393936,0.2849889057714648,139.85796976744186
10,2010-03-26,Hot Tub Time Machine,36000000,50269859,65967750,29967750,0.45427879532044074,0.2838651089114851,139.6384972222222
61,2002-12-20,Narc,7500000,10465659,11843260,4343260,0.3667284176822936,0.28337049773932055,139.54211999999998
28,2001-06-15,Lara Croft: Tomb Raider,94000000,131144183,273330185,179330185,0.6560935997610363,0.2832316474151202,139.51508829787232
73,2016-07-08,Mike and Dave Need Wedding Dates,33000000,46009673,75898100,42898100,0.5652065071457651,0.28275951885161194,139.42325151515152
21,2013-11-22,Delivery Man,22000000,30659817,70536870,48536870,0.6881063761405914,0.2824484242681553,139.36280454545457
81,2016-10-21,Iâm Not Ashamed,1500000,2082980,2082980,582980,0.27987786728629177,0.27987786728629177,138.86533333333333
4,2015-05-01,Avengers: Age of Ultron,330600000,459005868,1403013963,1072413963,0.7643644263574587,0.27974777002197276,138.8402504537205
69,2007-03-23,The Hills Have Eyes II,15000000,20804166,37466538,22466538,0.5996427532215547,0.2789905637169017,138.69444
26,2013-03-22,The Croods,135000000,187168425,573068425,438068425,0.7644260369082453,0.27872449639943275,138.6432777777778
23,2003-02-28,Cradle 2 the Grave,25000000,34657731,56434942,31434942,0.5570120369752484,0.2786602215823073,138.63092400000002
43,2015-07-17,Ant-Man,130000000,180202163,518858449,388858449,0.7494499699281181,0.27858801561666047,138.61704846153847
5,2015-01-16,Paddington,55000000,76223578,258789097,203789097,0.7874717264460334,0.27843849051536257,138.58832363636364
76,2013-03-22,Admission,13000000,18007317,18733666,5733666,0.3060621450174248,0.27807124181797876,138.5178230769231
76,2006-01-20,Underworld: Evolution,45000000,62318875,113417762,68417762,0.6032367487554551,0.27790737557441464,138.48638888888888
58,2009-10-16,Law Abiding Citizen,53000000,73357727,131159781,78159781,0.5959127135169584,0.2775130559865902,138.41080566037735
58,2015-10-16,Goosebumps,58000000,80069458,158905324,100905324,0.6350027894597163,0.2756289170834652,138.05078965517242
48,2004-07-16,"I, Robot",105000000,144801023,348629585,243629585,0.6988207412173583,0.2748670014575795,137.9057361904762
42,2006-12-15,Dreamgirls,75000000,103365956,155708695,80708695,0.518331330180373,0.2744226155079531,137.82127466666668
1,2007-06-08,Ocean's Thirteen,85000000,117144465,311744465,226744465,0.7273407885525729,0.27440020320208897,137.81701764705883
64,2005-07-15,Charlie and the Chocolate Factory,150000000,206459076,475825484,325825484,0.6847583724624552,0.27346376383085236,137.639384
65,2007-06-29,Ratatouille,150000000,206445654,626549695,476549695,0.7605936110143665,0.27341652830337615,137.630436
56,2008-12-25,Bedtime Stories,80000000,110101975,221468935,141468935,0.6387755239803722,0.27340086315436213,137.62746875
66,2005-12-21,Cheaper by the Dozen 2,60000000,82571173,135015330,75015330,0.555606018960958,0.27335415230203886,137.61862166666668
66,2013-11-08,Thor: The Dark World,150000000,206362140,644602516,494602516,0.7672984571471949,0.273122482641438,137.57476
24,2005-08-05,Broken Flowers,10000000,13744960,40744960,30744960,0.7545708720784117,0.2724605964659046,137.4496
70,2016-04-29,Keanu,15000000,20591853,20688141,5688141,0.27494693699158373,0.2715565714265734,137.27902
61,2006-11-03,Volver,9400000,12899867,87226613,77826613,0.892234724280765,0.271310316610241,137.23262765957446
62,2005-10-21,Shopgirl,7500000,10284523,11758418,4258418,0.36215909317052686,0.27074887187281316,137.12697333333332
59,2005-11-11,Pride & Prejudice,28000000,38372662,126549607,98549607,0.7787428925006459,0.2703138500008157,137.04522142857144
67,2005-06-15,Batman Begins,150000000,205343774,359142722,209142722,0.5823387449850648,0.269517662610019,136.89584933333333
25,2002-06-28,Hey Arnold! The Movie,10000000,13684949,13684949,3684949,0.2692702033452956,0.2692702033452956,136.84949
72,2001-05-11,A Knightâs Tale,41000000,56083966,100622586,59622586,0.5925368087836661,0.26895326910368644,136.79016097560975
22,2016-02-05,"Hail, Caesar!",22000000,30080225,64160680,42160680,0.6571108660319684,0.2686224920192585,136.72829545454545
23,2001-08-24,Jay and Silent Bob Strike Back,22000000,30059386,33762400,11762400,0.34838755538705773,0.2681154565166434,136.63357272727274
77,2012-09-21,The Perks of Being a Wallflower,13000000,17742948,33069303,20069303,0.6068861808185071,0.26731454096579665,136.4842153846154
44,2015-03-27,Home,130000000,177397510,385997896,255997896,0.6632105994691743,0.2671824987847913,136.45962307692307
29,2015-02-13,Kingsman: The Secret Service,94000000,128261724,404561724,310561724,0.7676497937802934,0.2671235262672752,136.4486425531915
40,2010-01-08,Leap Year,19000000,25918920,32618920,13618920,0.41751596925955864,0.2669447646738367,136.41536842105265
31,2014-11-26,Horrible Bosses 2,40000000,54445357,105945357,65945357,0.6224468808010152,0.26531843661159205,136.1133925
27,2015-12-25,The Revenant,135000000,183637894,532938302,397938302,0.7466873754553299,0.26485761157770626,136.02806962962964
9,2002-07-03,Men in Black 2,140000000,190418803,441767803,301767803,0.6830914361588275,0.2647784893385765,136.0134307142857
94,2011-12-09,Young Adult,12000000,16311571,22750356,10750356,0.4725357264739066,0.2643259193121251,135.92975833333333
89,2004-05-14,Breakin' All the Rules,9000000,12232382,12512317,3512317,0.2807087608154429,0.26424796086322355,135.91535555555555
14,2013-05-17,Frances Ha,3000000,4067398,11262769,8262769,0.7336356627752909,0.2624277240633938,135.57993333333334
32,2002-01-25,The Count of Monte Cristo,40000000,54228104,75389090,35389090,0.46941924885948355,0.2623750961309656,135.57026000000002
81,2019-05-24,Aladdin,182000000,246734314,619234314,437234314,0.7060886390091102,0.26236445571976663,135.5683043956044
24,2006-03-17,She's the Man,25000000,33889159,55279608,30279608,0.5477536671388842,0.26230096179135043,135.556636
49,2009-09-18,The Secrets of Jonathan Sperry,1000000,1355079,1355079,355079,0.26203564515426775,0.26203564515426775,135.5079
62,2015-05-22,Poltergeist,35000000,47425125,95713069,60713069,0.634323709753785,0.2619945651171188,135.50035714285715
86,2016-07-29,Jason Bourne,120000000,162192920,416168316,296168316,0.7116551275373879,0.26014033164949496,135.1607666666667
47,2009-11-06,The Men Who Stare at Goats,24000000,32428195,67348218,43348218,0.6436431324730819,0.25990330328283767,135.11747916666667
28,2001-04-27,The Forsaken,5000000,6755271,6755271,1755271,0.2598372441312865,0.2598372441312865,135.10542
29,2014-11-07,Big Hero 6,165000000,222527828,652127828,487127828,0.7469821208120565,0.2585197029829456,134.8653503030303
71,2010-12-22,Country Strong,15000000,20218921,20601987,5601987,0.2719148885978814,0.258120648475752,134.79280666666668
13,2006-11-10,Stranger Than Fiction,30000000,40435190,53572822,23572822,0.4400145655944725,0.2580719912531634,134.7839666666667
25,2014-12-10,The Gambler,25000000,33680992,38718031,13718031,0.3543060079682255,0.2577415772077022,134.72396799999999
100,2005-09-02,The Transporter 2,32000000,43095856,88978458,56978458,0.6403623897370756,0.2574692100326305,134.67454999999998
72,2006-04-28,Stick It,20000000,26910736,30399714,10399714,0.3420990736952328,0.2568021922551654,134.55368
15,2010-04-30,Please Give,3000000,4033574,4570178,1570178,0.34357042548452166,0.2562427266736646,134.45246666666665
73,2008-01-04,One Missed Call,20000000,26890041,44513466,24513466,0.5506977596397459,0.25623021549130404,134.450205
61,2004-12-22,Hotel Rwanda,17500000,23519128,36521223,19021223,0.5208265615858483,0.2559247944906801,134.39501714285714
20,2009-03-13,Race to Witch Mountain,50000000,67172595,105103784,55103784,0.5242797347810046,0.2556488252389237,134.34519
67,2010-08-13,Eat Pray Love,60000000,80574010,206598789,146598789,0.7095820343845287,0.25534300700685,134.29001666666667
53,2013-06-21,Monsters University,200000000,268488329,743588329,543588329,0.7310339710832122,0.25508866346290976,134.2441645
14,2011-04-08,Hanna,30000000,40259119,65343694,35343694,0.5408891330814569,0.25482721069976716,134.19706333333335
84,2014-05-30,Maleficent,180000000,241407328,758536735,578536735,0.7627010114414564,0.2543722616407071,134.11518222222222
38,2015-09-18,Maze Runner: The Scorch Trials,61000000,81697192,310566162,249566162,0.8035845257346484,0.2533403106437245,133.92982295081967
91,2003-09-05,Dickie Roberts: Former Child Star,17000000,22734486,23734486,6734486,0.2837426519369326,0.25223732790791925,133.73227058823528
15,2002-08-16,Blue Crush,30000000,40118420,51618420,21618420,0.41881212171933974,0.2522138209829799,133.72806666666665
68,2012-12-21,Jack Reacher,60000000,80070736,217370736,157370736,0.723973883954646,0.25066256416076904,133.45122666666666
21,2004-09-24,The Forgotten,50000000,66711892,117211892,67211892,0.5734221234138939,0.25050844008441553,133.42378399999998
63,2018-10-12,Goosebumps 2: Haunted Halloween,35000000,46697321,93291478,58291478,0.6248317558008889,0.2504923355239158,133.42091714285715
100,2009-04-10,Observe and Report,18000000,24007324,27148898,9148898,0.3369896634478497,0.25022880517628704,133.37402222222224
58,2016-04-22,The Meddler,3200000,4267219,5526942,2326942,0.42101798788552514,0.25009707727679314,133.35059375
26,2007-08-24,Mr. Beanâs Holiday,25000000,33302167,234981342,209981342,0.8936085742501204,0.2492981012316706,133.208668
40,2008-01-25,"4 luni, 3 saptamani si 2 zile",900000,1196321,11993156,11093156,0.9249572005900701,0.2476935538204211,132.92455555555557
33,2006-10-20,The Prestige,40000000,53089891,104407366,64407366,0.6168852684206209,0.2465608942387921,132.7247275
26,2012-08-17,Robot & Frank,2500000,3317468,4934356,2434356,0.4933482707773822,0.2464132284019017,132.69872
2,2009-12-25,Itâs Complicated,85000000,112735375,224614744,139614744,0.6215742631748163,0.24602193410896978,132.62985294117647
48,2013-09-20,Prisoners,46000000,61002302,113402302,67402302,0.5943644953521314,0.24593009621177903,132.6137
21,2018-07-20,The Equalizer 2,77000000,102084362,190453132,113453132,0.5957010567828309,0.24572188637472211,132.57709350649353
60,2011-08-12,30 Minutes or Less,28000000,37053924,40966716,12966716,0.31651831696736443,0.24434453959586036,132.33544285714285
43,2018-08-03,Christopher Robin,75000000,99215042,197504758,122504758,0.6202623128704575,0.24406623745621153,132.28672266666666
45,2018-12-19,Mary Poppins Returns,130000000,171958438,341528518,211528518,0.619358287380265,0.2440033678370584,132.27572153846154
89,2014-12-19,Annie,65000000,85911262,139829625,74829625,0.5351485781357134,0.24340536401385887,132.1711723076923
78,2003-11-07,Love Actually,45000000,59472278,248505300,203505300,0.8189173430103904,0.24334494131870987,132.16061777777776
18,2016-03-25,Batman v Superman: Dawn of Justice,250000000,330360194,867500281,617500281,0.7118156553081277,0.24325023250228506,132.1440776
75,2008-04-11,Street Kings,20000000,26418667,65457811,45457811,0.6944596879354856,0.24295953312103144,132.093335
22,2005-06-22,Herbie: Fully Loaded,50000000,66010682,144110682,94110682,0.6530444564824139,0.24254683507132982,132.021364
16,2007-10-19,30 Days of Night,30000000,39568996,80276156,50276156,0.6262900281373712,0.24183064943068053,131.89665333333335
30,2010-03-26,How to Train Your Dragon,165000000,217581232,494870992,329870992,0.6665797699453759,0.24166253457007725,131.86741333333333
22,2009-10-02,A Serious Man,7000000,9228788,30360570,23360570,0.7694377938227115,0.24150386811355945,131.83982857142857
90,2011-08-12,Glee: The 3D Concert Movie,9000000,11862398,17462398,8462398,0.48460686785400264,0.2413001148671626,131.80442222222223
58,2005-08-31,The Constant Gardener,25500000,33579798,86301599,60801599,0.7045245940344629,0.24061484824893825,131.68548235294116
7,2015-11-06,The Peanuts Movie,99000000,130178411,250091610,151091610,0.6041450570852817,0.23950523562620532,131.49334444444446
10,2012-02-10,Journey 2: The Mysterious Island,79000000,103860290,318146162,239146162,0.7516864591313221,0.23936280170217125,131.46872151898734
23,2010-07-30,Get Low,7000000,9176933,10828305,3828305,0.3535460997820065,0.23721792455060967,131.09904285714288
24,2009-12-11,A Single Man,7000000,9176000,28142379,21142379,0.7512648095599878,0.23714036617262424,131.0857142857143
48,2008-10-31,Zack and Miri Make a Porno,24000000,31457946,36856306,12856306,0.34882242403782954,0.23707669915893428,131.074775
53,2001-05-25,Pearl Harbor,151500000,198539855,449239855,297739855,0.6627636699775892,0.2369290286829312,131.0494092409241
64,2018-01-19,12 Strong,35000000,45819713,71118378,36118378,0.5078627918088908,0.2361366383940467,130.9134657142857
65,2009-01-23,Underworld 3: Rise of the Lycans,35000000,45802315,89102315,54102315,0.6071931464406958,0.2358464850521202,130.86375714285714
34,2006-06-16,The Lake House,40000000,52330111,114830111,74830111,0.6516593108579333,0.23562172455548586,130.8252775
72,2010-04-01,Clash of the Titans,125000000,163214888,493214888,368214888,0.746560772918112,0.2341384935423293,130.5719104
56,2016-12-21,Dangal,9500000,12391761,294654618,285154618,0.9677588626830889,0.23336158597635961,130.4395894736842
16,2007-05-04,Spider-Man 3,258000000,336530303,894860230,636860230,0.711686818398444,0.23335284311677573,130.4381019379845
6,2006-04-28,R.V.,55000000,71724497,87473024,32473024,0.37123472489072745,0.23317691583114206,130.4081763636364
78,2001-06-29,crazy/beautiful,13000000,16929123,19929123,6929123,0.3476883052003844,0.23209253072353483,130.22402307692306
72,2007-11-02,American Gangster,100000000,130164645,267985456,167985456,0.6268454210440435,0.23174222923590349,130.164645
57,2002-07-12,Road to Perdition,80000000,104054514,183354514,103354514,0.5636867713003237,0.2311722295872719,130.0681425
93,2018-10-26,Indivisible,2700000,3511417,3588305,888305,0.2475556007641491,0.23107964676368542,130.05248148148146
68,2015-07-31,Mission: ImpossibleâRogue Nation,150000000,195042377,688858992,538858992,0.782248614386963,0.23093636210145244,130.02825133333334
76,2013-08-23,The World's End,20000000,26004851,47508505,27508505,0.5790227455063046,0.23091272470663263,130.024255
85,2016-11-18,Fantastic Beasts and Where to Find Them,180000000,234037575,802402853,622402853,0.7756737786673846,0.23089273164789884,130.020875
35,2010-07-09,Predators,40000000,52000688,127234389,87234389,0.6856195851264708,0.2307794081493691,130.00172
27,2016-04-29,Motherâs Day,25000000,32492859,52367022,27367022,0.5226003113180658,0.2306001758724894,129.971436
50,2003-07-04,Swimming Pool,7800000,10130108,24021282,16221282,0.6752879384206055,0.23001808075491398,129.8731794871795
69,2004-04-23,Man on Fire,60000000,77906816,130968579,70968579,0.5418748492338762,0.2298491572290671,129.84469333333334
97,2008-04-04,Nim's Island,37000000,48006762,101857425,64857425,0.6367471492628053,0.22927524251687711,129.74800540540542
20,2011-07-29,The Smurfs,110000000,142614158,563749323,453749323,0.8048778144608076,0.22868808018345557,129.64923454545453
36,2012-08-15,The Odd Life of Timothy Green,40000000,51853450,55249159,15249159,0.276007079130381,0.22859520436923675,129.633625
52,2008-12-19,Seven Pounds,54000000,69951824,166617328,112617328,0.6759040572298699,0.22804014374235618,129.54041481481482
61,2002-06-21,Minority Report,102000000,132024714,358824714,256824714,0.7157386433533115,0.22741737581041077,129.43599411764706
29,2013-06-14,Man of Steel,225000000,291045518,667999518,442999518,0.6631734096550652,0.22692504751095324,129.35356355555555
78,2018-10-05,The Hate U Give,23000000,29719483,35067665,12067665,0.3441251363613745,0.226096900810825,129.21514347826087
23,2015-09-18,Captive,2000000,2583301,2791973,791973,0.2836606944264862,0.22579676158527404,129.16505
83,2005-06-10,High Tension,2850000,3681066,6435262,3585262,0.5571275885892447,0.22576775314542039,129.16021052631578
58,2011-02-11,Just Go With It,80000000,103028109,214974953,134974953,0.6278636237217831,0.22351287647141035,128.78513625000002
29,2017-02-17,Fist Fight,25000000,32187017,40286416,15286416,0.37944343324062385,0.2232893156889935,128.74806800000002
50,2008-02-15,Dolphins and Whales Tribes of the Ocean 3D,6000000,7714996,17252287,11252287,0.6522200216122072,0.22229382879783735,128.58326666666667
78,2010-09-24,You Again,20000000,25702053,32838945,12838945,0.3909670362430949,0.22185204427054914,128.510265
96,2009-10-30,The Boondock Saints 2: All Saints Day,8000000,10273187,10629320,2629320,0.24736483613250898,0.22127378777394005,128.4148375
49,2018-06-13,Superfly,16000000,20537137,20723581,4723581,0.22793266279606791,0.22092353963456543,128.35710625000002
77,2012-06-22,Brave,185000000,237282182,554606532,369606532,0.6664301818933499,0.2203375810156702,128.26063891891891
59,2003-02-14,Daredevil,80000000,102543518,182782518,102782518,0.5623213813040917,0.21984342296506737,128.1793975
18,2006-09-15,Gridiron Gang,30000000,38432823,41457834,11457834,0.2763731940264897,0.21941721533180114,128.10941
79,2007-06-15,Nancy Drew,20000000,25584685,30703845,10703845,0.34861578411433486,0.21828234351917955,127.92342500000001
72,2002-10-11,Tuck Everlasting,15000000,19161999,19344615,4344615,0.22459040926893606,0.21720066888637246,127.74665999999999
95,2013-11-01,About Time,12000000,15323921,89309178,77309178,0.8656353101805504,0.21691060662607176,127.69934166666668
2,2009-09-18,Love Happens,18000000,22965110,36133014,18133014,0.501840615897694,0.21620231734139309,127.58394444444446
8,2003-10-10,Kill Bill: Volume 1,55000000,70098138,176469428,121469428,0.6883312842154168,0.2153857210871992,127.45116
20,2008-01-25,Meet the Spartans,30000000,38233676,84646831,54646831,0.6455862594548872,0.21535140905624664,127.44558666666667
38,2006-12-08,Apocalypto,40000000,50866635,121032272,81032272,0.669509632934925,0.21362991674208448,127.1665875
29,2018-09-21,Fahrenheit 11/9,5000000,6352306,6653715,1653715,0.24854010128176512,0.21288426596577684,127.04612
60,2008-09-26,Eagle Eye,80000000,101440743,180585259,100585259,0.5569959561317239,0.21136224327536718,126.80092875
69,2017-07-21,Dunkirk,150000000,190068280,499837368,349837368,0.6999023890506721,0.2108099257803564,126.71218666666665
30,2007-11-21,August Rush,25000000,31664162,65882103,40882103,0.6205342746876189,0.2104638676368571,126.656648
97,2011-04-29,Prom,8000000,10130219,10763183,2763183,0.2567254500829355,0.21028360788646328,126.62773750000001
98,2016-02-12,How to be Single,37000000,46843513,100003780,63003780,0.6300139854713492,0.2101360971795604,126.6040891891892
39,2007-02-14,Music and Lyrics,40000000,50572589,146196885,106196885,0.7263963592657942,0.20905769724385675,126.4314725
91,2001-11-21,Out Cold,11000000,13906394,14786394,3786394,0.25607284642895356,0.20899695492591394,126.42176363636364
10,2011-07-22,Captain America: The First Avenger,140000000,176654505,370569776,230569776,0.6222034038739306,0.20749261390192114,126.18178928571429
31,2004-08-27,Anacondas: The Hunt for the Blood Orchid,25000000,31526393,70326393,45326393,0.6445146845509339,0.20701362823206576,126.10557200000001
71,2011-09-09,Contagion,60000000,75658097,137551594,77551594,0.5638000385513526,0.2069586418490013,126.09682833333333
26,2005-12-30,The Matador,10000000,12589255,17300838,7300838,0.4219933161619107,0.20567182092983263,125.89254999999999
34,2010-08-13,The Expendables,82000000,103068524,268268174,186268174,0.6943357134864607,0.20441278464412665,125.69332195121952
24,2002-08-02,Full Frontal,2000000,2512846,3438804,1438804,0.41840244457084497,0.2040897054574773,125.6423
73,2006-10-13,The Marine,15000000,18844784,22165608,7165608,0.3232759507431513,0.2040237765527055,125.63189333333334
80,2010-09-17,Alpha and Omega 3D,20000000,25107267,48958353,28958353,0.5914895258016544,0.20341787897503938,125.53633500000001
74,2009-02-06,Coraline,60000000,75286229,126037057,66037057,0.5239495317635035,0.20304150178646882,125.47704833333333
41,2014-05-16,Godzilla,160000000,200676069,529076069,369076069,0.6975860195256725,0.2026951654110785,125.422543125
66,2005-07-29,Must Love Dogs,35000000,43894863,58405313,23405313,0.4007394498510777,0.20264018138067774,125.41389428571428
62,2010-12-17,Yogi Bear,80000000,100246011,204774690,124774690,0.60932671903935,0.201963258168946,125.30751375
9,2006-09-01,Crossover,5600000,7009668,7009668,1409668,0.20110339034601923,0.20110339034601923,125.17264285714285
67,2007-07-03,License to Wed,35000000,43799818,70187088,35187088,0.5013327807530639,0.2009099215891719,125.14233714285714
23,2010-01-22,Tooth Fairy,48000000,60022256,112610386,64610386,0.5737515720796836,0.20029663663425112,125.04636666666667
73,2009-09-18,Cloudy with a Chance of Meatballs,100000000,124870275,236827677,136827677,0.5777520547144496,0.1991688974818066,124.870275
3,2009-09-25,Fame,18000000,22455510,80227619,62227619,0.7756383621455848,0.19841499925853387,124.75283333333334
62,2018-12-21,Bumblebee,102000000,127195589,465195589,363195589,0.7807373878603135,0.19808539901489822,124.70155784313725
56,2019-02-22,How to Train Your Dragon: The Hidden World,129000000,160791800,519258283,390258283,0.7515687198002772,0.19772028175566167,124.64480620155038
92,2006-03-31,ATL,17000000,21170563,21170563,4170563,0.1969982092587712,0.19699820925877123,124.53272352941175
81,2011-03-04,The Adjustment Bureau,50200000,62495645,126931325,76731325,0.6045105493068791,0.19674402912394937,124.49331673306774
86,2008-06-27,WALL-E,180000000,223808164,532508025,352508025,0.6619769251364803,0.19573979437139746,124.33786888888889
96,2018-12-14,If Beale Street Could Talk,12000000,14915773,19859167,7859167,0.39574504811808076,0.19548252712078684,124.29810833333332
49,2001-01-12,Double Take,24000000,29823162,29823162,5823162,0.195256358128625,0.195256358128625,124.26317499999999
75,2004-10-01,Ladder 49,60000000,74541707,102332848,42332848,0.4136780010266107,0.19508148639526057,124.23617833333334
9,2011-06-17,Mr. Poppers's Penguins,55000000,68224452,189624452,134624452,0.7099530180843978,0.19383742356772612,124.04445818181817
39,2013-08-02,2 Guns,61000000,75612460,132493015,71493015,0.5395983705254198,0.19325465670605083,123.95485245901638
51,2003-09-19,Bubba Ho-Tep,1000000,1239183,1492895,492895,0.3301605270296973,0.1930166892218502,123.91829999999999
92,2018-07-27,Mission: ImpossibleâFallout,178000000,220159104,787456552,609456552,0.7739557826423419,0.19149380259105706,123.68488988764045
93,2001-03-30,Tomcats,11000000,13558739,13558739,2558739,0.18871511576408395,0.18871511576408395,123.26126363636362
81,2018-12-25,On the Basis of Sex,20000000,24622687,38073377,18073377,0.4746985537952149,0.18774096425788137,123.11343500000001
22,2013-09-13,The Family,30000000,36918811,51078541,21078541,0.41266920682013997,0.18740611662710374,123.06270333333333
73,2016-11-04,Trolls,125000000,153707064,344150134,219150134,0.6367864264728138,0.18676476703764247,122.9656512
50,2008-08-13,Tropic Thunder,90000000,110515313,191145256,101145256,0.5291538912166358,0.18563321627655346,122.79479222222223
17,2014-07-11,Dawn of the Planet of the Apes,170000000,208545589,710644566,540644566,0.7607805531295655,0.18483051684205126,122.67387588235295
21,2007-06-27,Live Free or Die Hard,110000000,134529403,382288147,272288147,0.7122589312192303,0.182334883326584,122.29945727272727
32,2011-12-09,The Sitter,25000000,30542576,38749404,13749404,0.3548287865279167,0.18147048238498284,122.170304
99,2014-06-13,How to Train Your Dragon 2,145000000,177002924,614586270,469586270,0.7640689239608298,0.1808044933766179,122.07098206896552
18,2012-05-25,Les Intouchables,10800000,13182281,484873045,474073045,0.9777261282899319,0.18071842043118336,122.05815740740739
31,2010-05-28,Sea Rex 3D: Journey to a Prehistoric World,5000000,6096582,16515203,11515203,0.6972486502285197,0.17986832621951118,121.93164
32,2006-01-06,Grandmaâs Boy,5000000,6090172,6590172,1590172,0.24129446090329656,0.17900512497840784,121.80344000000001
81,2016-12-09,Office Christmas Party,45000000,54767494,91323299,46323299,0.507245133577577,0.17834473127435774,121.70554222222223
59,2002-12-06,Adaptation,18500000,22498520,32531759,14031759,0.43132494003782573,0.17772369026940438,121.61362162162162
99,2010-02-26,Cop Out,37000000,44875481,55909910,18909910,0.3382210774440524,0.17549630275829245,121.28508378378378
19,2012-12-14,The Hobbit: An Unexpected Journey,250000000,303003568,1017003568,767003568,0.7541798201439545,0.1749272074578343,121.2014272
23,2003-02-07,Shanghai Knights,50000000,60470220,88316835,38316835,0.4338565235042673,0.17314671585451483,120.94044
23,2018-02-09,The 15:17 to Paris,30000000,36276286,56096200,26096200,0.4652044166984573,0.17301346670384063,120.92095333333333
20,2009-07-15,Harry Potter and the Half-Blood Prince,250000000,302089278,935213767,685213767,0.7326814373125026,0.17243007876631755,120.8357112
70,2011-05-06,Thor,150000000,181030624,449326618,299326618,0.6661671176578281,0.17141091001266173,120.68708266666665
70,2002-10-11,The Transporter,21000000,25296447,43928932,22928932,0.521955143366563,0.1698438915156741,120.45927142857143
94,2013-12-06,Inside Llewyn Davis,11000000,13248209,32943247,21943247,0.6660924164518452,0.1696990891372562,120.43826363636363
68,2013-05-16,Star Trek Into Darkness,190000000,228778661,467381584,277381584,0.5934799176854174,0.16950296339045362,120.40982157894737
11,2004-04-16,Kill Bill: Volume 2,55000000,66207920,153535982,98535982,0.6417777820967074,0.16928367482319337,120.37803636363635
77,2009-10-28,Michael Jackson's This Is It,60000000,72091016,252091016,192091016,0.7619907248102804,0.16771876262639993,120.15169333333333
71,2008-11-07,Madagascar: Escape 2 Africa,150000000,180174880,599680774,449680774,0.7498669183614681,0.16747551045961567,120.11658666666666
72,2009-05-01,X-Men Origins: Wolverine,150000000,179883157,374825760,224825760,0.599814057603725,0.16612537548470976,119.92210466666666
41,2004-03-12,Secret Window,40000000,47958031,92111551,52111551,0.5657439315075695,0.16593740055758335,119.89507749999999
2,2017-11-22,Coco,175000000,209726015,798008101,623008101,0.780703980597811,0.1655780042356691,119.84343714285714
55,2015-06-26,Ted 2,68000000,81476385,217214143,149214143,0.6869448781702948,0.1654023432679297,119.81821323529411
42,2005-08-12,The Skeleton Key,40000000,47907715,92256918,52256918,0.5664281783182915,0.16506141025511237,119.7692875
63,2003-12-25,Cold Mountain,80000000,95632614,165173909,85173909,0.5156620044634289,0.16346530065569473,119.5407675
10,2011-03-11,Battle: Los Angeles,70000000,83552429,213463976,143463976,0.6720758166708185,0.16220269311380522,119.36061285714285
25,2018-06-08,Hearts Beat Loud,2000000,2386254,2420962,420962,0.1738821179349366,0.16186625564587845,119.3127
74,2010-08-06,The Other Guys,100000000,119219978,170936470,70936470,0.4149873341832787,0.16121440653176433,119.219978
95,2002-04-12,Frailty,11000000,13110448,19947280,8947280,0.44854636822664545,0.1609745143720489,119.18589090909092
97,2017-07-14,Wish Upon,12000000,14301505,23477345,11477345,0.4888689500452458,0.16092746882233722,119.17920833333334
51,2010-03-12,Remember Me,16000000,19068240,56506120,40506120,0.716844830259094,0.16090840056554773,119.17649999999999
14,2002-10-04,Red Dragon,78000000,92955420,206455420,128455420,0.6221944669701576,0.1608880902264763,119.17361538461539
31,2012-07-03,The Amazing Spider-Man,220000000,262030663,757890267,537890267,0.7097205102384565,0.1604036051307476,119.10484681818181
79,2001-03-30,Someone Like You,23000000,27338033,38684906,15684906,0.4054528657766417,0.1586812408924958,118.86101304347827
25,2011-07-01,Larry Crowne,30000000,35608245,61449135,31449135,0.5117913376648833,0.15749849508168684,118.69415000000001
75,2004-12-17,Lemony Snicket's A Series of Unfortunate Events,100000000,118627117,212956024,112956024,0.5304194822871036,0.15702242009303827,118.627117
83,2005-11-23,"Yours, Mine and Ours",45000000,53359917,72359917,27359917,0.3781087394005717,0.15667035239203989,118.57759333333333
64,2010-01-15,The Book of Eli,80000000,94835059,158750817,78750817,0.4960655856026241,0.15643011304500795,118.54382375000002
1,2011-02-18,"Big Mommas: Like Father, Like Son",32000000,37915414,82332450,50332450,0.6113318624673504,0.15601607304090098,118.48566875
22,2015-03-20,The Divergent Series: Insurgent,110000000,130179072,295075882,185075882,0.6272145345989341,0.15501010792272354,118.34461090909092
71,2008-03-14,Never Back Down,21000000,24850922,39319801,18319801,0.4659179480587911,0.15496093062462632,118.33772380952381
24,2014-07-18,Planes: Fire and Rescue,50000000,59157732,156399644,106399644,0.6803061776790232,0.1548019454160278,118.31546399999999
73,2009-05-22,Night at the Museum: Battle of the Smithsonian,150000000,177243721,402231063,252231063,0.627080019923772,0.15370767915665684,118.16248066666665
59,2015-09-18,Black Mass,53000000,62575678,98837872,45837872,0.4637683012843498,0.15302555730998232,118.06731698113207
24,2001-08-17,Rat Race,48000000,56607223,86607223,38607223,0.44577370873558664,0.15205167368835598,117.93171458333333
35,2002-11-08,Far From Heaven,13500000,15901849,29027914,15527914,0.5349304121543146,0.15104212095084038,117.79147407407406
43,2014-06-20,Jersey Boys,40000000,47047013,65282732,25282732,0.3872805445703467,0.14978661875940988,117.6175325
26,2013-10-18,Carrie,30000000,35266619,82409520,52409520,0.6359643885803485,0.14933722452951897,117.55539666666665
29,2006-01-20,End of the Spear,10000000,11748661,11924041,1924041,0.16135813353878942,0.14883917409822275,117.48661
84,2005-05-13,Kicking and Screaming,45000000,52842724,55842724,10842724,0.19416538491209706,0.14841634583410196,117.42827555555554
54,2013-03-08,Oz the Great and Powerful,200000000,234770996,490359051,290359051,0.5921356002461143,0.14810601220944686,117.385498
91,2016-08-12,Peteâs Dragon,65000000,76233151,137768975,72768975,0.5281956623397974,0.14735257368542984,117.28177076923076
25,2006-02-10,Curious George,50000000,58640119,71052604,21052604,0.29629602315490083,0.14734143019048102,117.280238
82,2014-02-14,Endless Love,20000000,23438250,34718173,14718173,0.4239328204280796,0.14669397245954796,117.19125
55,2014-05-23,X-Men: Days of Future Past,200000000,233921534,747862775,547862775,0.7325712594800564,0.14501244678055164,116.960767
76,2013-12-25,The Wolf of Wall Street,100000000,116900694,389870414,289870414,0.7435045173753554,0.14457308525473767,116.900694
37,2014-06-27,Transformers: Age of Extinction,210000000,245439076,1104039076,894039076,0.8097893411881375,0.14439052076613912,116.87575047619048
83,2006-09-08,The Covenant,20000000,23364784,38164784,18164784,0.47595668299865135,0.14401091831193474,116.82391999999999
12,2014-09-12,Dolphin Tale 2,36000000,42024533,57824533,21824533,0.37742687865719554,0.1433575240443481,116.7348138888889
97,2006-05-05,An American Haunting,14000000,16298046,30443277,16443277,0.5401283508342417,0.14100132003554292,116.4146142857143
69,2008-10-17,Max Payne,35000000,40689393,87775050,52775050,0.6012534313566327,0.13982496617730325,116.25540857142857
84,2011-07-01,Monte Carlo,20000000,23186769,39686769,19686769,0.49605370999085374,0.1374391145225969,115.93384499999999
51,2009-01-30,Entre les murs,3250000,3766810,34114067,30864067,0.9047313825115018,0.13720097376825482,115.90184615384615
93,2001-08-24,Summer Catch,17000000,19693891,19693891,2693891,0.1367881542555506,0.1367881542555506,115.84641764705883
27,2006-04-07,Take the Lead,30000000,34742066,65390493,35390493,0.5412177118774743,0.1364934946586078,115.80688666666667
11,2006-11-17,Let's Go to Prison,4000000,4630045,4630045,630045,0.1360775111257018,0.1360775111257018,115.751125
30,2001-03-09,Get Over It,10000000,11560259,19860259,9860259,0.49648189381618846,0.1349674778047793,115.60258999999999
85,2006-03-24,Stay Alive,20000000,23086480,23187506,3187506,0.1374665304668816,0.13369210031152431,115.43239999999999
36,2014-04-11,Draft Day,25000000,28842237,29847480,4847480,0.16240835072173598,0.13321563788550797,115.36894799999999
8,2013-07-26,The Wolverine,115000000,132556852,416456852,301456852,0.7238609487448174,0.13244771383074186,115.26682782608695
26,2017-01-20,The Resurrection of Gavin Stone,2000000,2303792,2303792,303792,0.13186607124254274,0.13186607124254274,115.1896
44,2008-05-02,Made of Honor,40000000,46012734,106548738,66548738,0.6245849481577154,0.13067543432650622,115.031835
72,2011-12-09,Tinker Tailor Soldier Spy,21000000,24149393,81452811,60452811,0.7421820101457272,0.13041292590666773,114.99710952380953
86,2005-10-07,2 For the Money,20000000,22991379,30491379,10491379,0.34407689465274754,0.13010872466588455,114.95689499999999
76,2014-07-25,A Most Wanted Man,15000000,17237855,36068890,21068890,0.5841291484157123,0.129822126940968,114.91903333333333
3,2018-11-21,Ralph Breaks The Internet,175000000,201091711,524283695,349283695,0.6662112484730237,0.12975030581941788,114.90954914285713
46,2011-10-28,Puss in Boots,130000000,149260504,554987477,424987477,0.7657604803936864,0.12903952139944536,114.81577230769231
31,2012-11-02,Wreck-It Ralph,165000000,189412677,496511521,331511521,0.6676814272754811,0.12888618326216889,114.79556181818182
11,2004-08-13,AVP: Alien Vs. Predator,70000000,80281096,172543519,102543519,0.5943052488688375,0.12806372249825787,114.68727999999999
70,2002-03-15,Resident Evil,35000000,40119709,103787401,68787401,0.662772170198192,0.1276108209060041,114.62774
15,2001-12-28,Black Hawk Down,95000000,108638745,159691085,64691085,0.40510141815368084,0.12554218110674972,114.35657368421053
27,2008-12-25,Waltz with Bashir,2000000,2283849,13912289,11912289,0.8562422042842841,0.12428536212332777,114.19245000000001
47,2010-11-05,Megamind,130000000,148415853,321887208,191887208,0.5961318226724934,0.12408278918829513,114.16604076923076
23,2004-12-10,Ocean's Twelve,110000000,125531634,362989076,252989076,0.6969605774031613,0.12372685278676449,114.11966727272727
12,2011-12-25,War Horse,70000000,79883359,156815529,86815529,0.5536156371350187,0.12372237627113301,114.1190842857143
32,2014-11-05,Interstellar,165000000,188017894,666379375,501379375,0.7523932969864201,0.12242395396684956,113.95023878787877
51,2011-12-20,The Girl with the Dragon Tattoo,90000000,102515793,239373970,149373970,0.62401926993148,0.12208648671332036,113.90643666666666
4,2017-04-28,The Circle,18000000,20497844,40651864,22651864,0.5572158757591041,0.12185886476646032,113.87691111111111
26,2012-04-06,American Reunion,50000000,56758835,236799211,186799211,0.7888506478174035,0.11907987540618126,113.51767
77,2009-06-26,The Hurt Locker,15000000,17017811,49894223,34894223,0.6993639925006948,0.1185705376561063,113.45207333333333
71,2004-03-26,The Ladykillers,35000000,39692139,77392139,42392139,0.5477576863458962,0.11821330667011924,113.40611142857142
28,2018-03-02,Death Wish,30000000,34017028,48575965,18575965,0.382410622207917,0.11808874073302347,113.39009333333334
85,2005-04-29,The Hitchhiker's Guide to the Galaxy,45000000,51019112,102746214,57746214,0.5620276577782224,0.11797759239713933,113.37580444444444
4,2009-03-27,Monsters vs. Aliens,175000000,198351526,381687380,206687380,0.541509598771644,0.11772798763343016,113.34372914285716
5,2002-11-22,Die Another Day,142000000,160942139,431942139,289942139,0.6712522646464923,0.11769533521609278,113.33953450704226
23,2007-08-03,Becoming Jane,16500000,18663911,39380876,22880876,0.581014906829396,0.11594091934964756,113.11461212121212
41,2013-11-08,The Book Thief,19000000,21488481,76086711,57086711,0.7502849084907875,0.11580534706012957,113.09726842105263
22,2001-07-20,Ghost World,5500000,6217849,8761608,3261608,0.3722613474604205,0.11544973189281374,113.05179999999999
80,2015-10-16,Room,13000000,14677674,36262783,23262783,0.6415057277870814,0.11430108067531682,112.90518461538461
86,2007-09-21,Resident Evil: Extinction,45000000,50648679,149871103,104871103,0.6997419842836546,0.11152667969879333,112.55261999999999
21,2002-11-22,The Emperor's Club,12500000,14060950,16193713,3693713,0.2280954960730748,0.11101312500222246,112.4876
86,2012-01-13,Joyful Noise,27500000,30932113,31157914,3657914,0.11739919431063325,0.11095630615341409,112.4804109090909
25,2007-09-07,3:10 to Yuma,48000000,53606916,71171825,23171825,0.32557581599179175,0.10459314615300758,111.68107499999999
38,2006-05-26,X-Men: The Last Stand,210000000,234362462,459260946,249260946,0.5427436148685719,0.10395206549758809,111.60117238095238
13,2002-03-01,We Were Soldiers,70000000,78120196,114658262,44658262,0.3894901354775463,0.10394490049666542,111.60028
72,2011-05-06,Something Borrowed,35000000,39046489,65084116,30084116,0.46223437989078625,0.10363259549405325,111.56139714285713
14,2014-02-07,The Monuments Men,70000000,78031620,158702748,88702748,0.5589238316150644,0.10292776184833789,111.47374285714287
27,2013-01-25,Hansel & Gretel: Witch Hunters,50000000,55703475,214949716,164949716,0.767387457260004,0.10238993168738575,111.40695000000001
45,2011-11-11,Immortals,75000000,83504017,211562435,136562435,0.6454947212155127,0.10183961569178163,111.33868933333333
36,2012-10-12,Seven Psychopaths,13500000,15024049,33035736,19535736,0.5913516199548271,0.10144063028548429,111.28925185185186
78,2003-01-17,Kangaroo Jack,60000000,66723216,90723216,30723216,0.3386477833854567,0.10076276898883291,111.20536000000001
52,2010-03-19,City Island,6000000,6671283,8173486,2173486,0.2659190949859093,0.10062277376030968,111.18805
38,2017-02-03,Rings,25000000,27793018,82917283,57917283,0.6984947034504255,0.10049351243538934,111.17207200000001
80,2014-01-10,Her,23000000,25568251,48163815,25163815,0.5224630773122935,0.10044687843529071,111.16630869565218
53,2008-06-06,You Don't Mess With the Zohan,90000000,100018837,202910991,112910991,0.5564557663611234,0.10016950107108324,111.1320411111111
98,2003-08-22,My Boss's Daughter,14000000,15549702,15549702,1549702,0.0996612025105047,0.0996612025105047,111.0693
99,2009-08-07,A Perfect Getaway,14000000,15515460,22815460,8815460,0.3863809890311219,0.09767419077487874,110.82471428571428
81,2015-10-16,Woodlawn,13000000,14394097,14403703,1403703,0.09745431435235787,0.0968519942584797,110.72382307692308
66,2013-09-06,Riddick,38000000,42025135,94763758,56763758,0.5990028170896304,0.09577922831181863,110.59246052631579
87,2017-06-16,Rough Night,20000000,22105643,46844357,26844357,0.5730542314840611,0.09525364179635037,110.528215
28,2011-02-18,I am Number Four,50000000,55100437,146195159,96195159,0.6579914113298375,0.09256618055497455,110.200874
74,2011-05-26,Kung Fu Panda 2,150000000,165249063,664837547,514837547,0.7743809737027383,0.0922792705941092,110.166042
61,2015-04-10,The Longest Ride,34000000,37446117,63802928,29802928,0.4671090956828815,0.09202868751384823,110.13563823529411
18,2004-11-10,The Polar Express,170000000,187224605,311365187,141365187,0.45401731761360975,0.09199968668648012,110.1321205882353
29,2001-09-28,Donât Say a Word,50000000,54997476,104488383,54488383,0.5214779043905771,0.09086736998621536,109.994952
3,2007-02-23,The Number 23,32000000,35193167,77593167,45593167,0.5875925518029185,0.09073258453835654,109.97864687500001
87,2007-06-15,Fantastic Four: Rise of the Silver Surfer,120000000,131921738,289480691,169480691,0.5854645793974562,0.0903697766625846,109.93478166666665
41,2009-12-04,Brothers,26000000,28544157,45043870,19043870,0.42278494276801704,0.08913057057526695,109.78521923076923
86,2012-05-18,What to Expect When You're Expecting,37500000,41152203,88473016,50973016,0.5761419504450939,0.08874866310316364,109.739208
64,2014-02-21,3 Days to Kill,28000000,30697999,38959900,10959900,0.28131232369692943,0.08788843207663144,109.63571071428571
62,2006-08-25,Beerfest,17500000,19185184,20159316,2659316,0.1319149915602295,0.08783778148804827,109.62962285714286
20,2002-05-24,Thirteen Conversations About One Thing,3000000,3287435,3705923,705923,0.19048506944153992,0.08743442836132122,109.58116666666666
47,2007-02-02,Because I Said So,39000000,42674040,69538833,30538833,0.4391622879262297,0.08609543413278893,109.42061538461539
51,2017-05-12,Snatched,42000000,45852178,57852177,15852177,0.2740117627725574,0.08401297752966064,109.17185238095237
56,2005-06-24,George A. Romero's Land of the Dead,18975000,20700082,47751015,28776015,0.6026262478399674,0.08333696455888435,109.09134123847168
57,2013-05-23,The Hangover 3,103000000,112200072,362000072,259000072,0.7154696698513363,0.08199702403043022,108.93210873786407
61,2001-05-18,Moulin Rouge,53000000,57386369,179200588,126200588,0.7042420418843715,0.076435729885611,108.2761679245283
93,2006-08-09,World Trade Center,65000000,70278893,163295654,98295654,0.6019489900202732,0.07511349104488597,108.12137384615386
29,2010-11-24,Love and Other Drugs,30000000,32367005,102716321,72716321,0.707933464634116,0.07313018303670667,107.89001666666667
30,2015-06-03,Entourage,30000000,32363404,46438538,16438538,0.3539848304440592,0.07302705240771336,107.87801333333333
28,2006-04-14,Hard Candy,950000,1024640,8267066,7317066,0.8850861962393914,0.07284509681449094,107.85684210526315
79,2006-03-24,Boynton Beach Club,2900000,3127472,3127472,227472,0.07273350488829317,0.07273350488829317,107.84386206896552
52,2012-10-12,Here Comes the Boom,42000000,45290318,73239258,31239258,0.42653706295058313,0.07264947885771082,107.83409047619048
60,2015-11-20,Carol,11800000,12711491,42843521,31043521,0.7245791259779979,0.07170606500842426,107.7245
31,2001-06-01,What's the Worst That Could Happen?,30000000,32267774,38462071,8462071,0.22001079973046692,0.07027984018978192,107.55924666666668
77,2013-05-24,Epic,100000000,107518682,262794441,162794441,0.6194744469499642,0.06992907520945987,107.51868200000001
73,2006-12-01,The Nativity Story,35000000,37629831,46309644,11309644,0.24421789983961006,0.06988686715069223,107.51380285714285
79,2008-06-13,The Happening,60000000,64506874,162778384,102778384,0.6314006901555185,0.06986656956900439,107.51145666666666
23,2003-03-28,Head of State,35200000,37788228,38283765,3083765,0.08055020189367477,0.06849297087971418,107.35292045454545
74,2011-10-28,In Time,35000000,37553932,165103952,130103952,0.7880123426724516,0.0680070465058093,107.29694857142857
68,2014-10-17,Fury,80000000,85817906,210315681,130315681,0.6196194234323402,0.06779361407396726,107.27238249999999
32,2013-02-08,Side Effects,30000000,32172757,66742138,36742138,0.550508855440022,0.06753406305838197,107.24252333333332
75,2010-04-23,The Back-up Plan,35000000,37490007,75281179,40281179,0.5350763568673652,0.0664178857048493,107.1143057142857
25,2008-08-27,Traitor,22000000,23530831,27882226,5882226,0.2109668718702732,0.06505639346098742,106.95832272727273
87,2004-12-25,Fat Albert,45000000,48114556,48563556,3563556,0.07337922288886753,0.0647320947947644,106.92123555555555
8,2019-02-08,The LEGO Movie 2: The Second Part,99000000,105806508,190325698,91325698,0.47983902835864023,0.06432976693645348,106.8752606060606
42,2007-10-19,"Gone, Baby, Gone",19000000,20300218,34352162,15352162,0.446905263197117,0.06404945996146445,106.84325263157895
48,2014-05-30,A Million Ways to Die in The West,40000000,42720965,86778557,46778557,0.5390566358461112,0.0636915622107319,106.8024125
52,2001-12-07,No Man's Land,1000000,1067481,2684207,1684207,0.6274504909643704,0.06321517666356591,106.7481
27,2010-06-18,Cyrus,7000000,7468936,10062896,3062896,0.3043752017311915,0.06278484646273579,106.69908571428573
100,2008-10-03,Rachel Getting Married,12000000,12796861,17475475,5475475,0.3133233860596064,0.0622700363784525,106.64050833333334
76,2011-11-09,J. Edgar,35000000,37306030,84606030,49606030,0.5863179019273212,0.06181386762408115,106.58865714285714
48,2003-07-18,Bad Boys II,130000000,138540870,273271982,143271982,0.5242834664257677,0.061648739465834164,106.56989999999999
69,2013-06-21,World War Z,190000000,202359711,531514650,341514650,0.6425310196059506,0.06107792375726411,106.50511105263159
49,2011-08-12,Final Destination 5,40000000,42587643,155011165,115011165,0.7419540715018819,0.06076041822741869,106.4691075
74,2012-07-27,Step Up Revolution,33000000,35074677,165552290,132552290,0.8006672091337425,0.059150280984768586,106.2869
35,2001-07-13,Made,5000000,5308707,5476060,476060,0.08693476696749122,0.05815107143792264,106.17414000000001
67,2001-03-23,Heartbreakers,38000000,40334024,57753825,19753825,0.3420349214965416,0.05786737271738619,106.14216842105265
50,2018-11-16,Widows,40000000,42402632,73866088,33866088,0.45847951227632355,0.05666233171563501,106.00658
73,2017-09-22,Victoria and Abdul,21000000,22245070,68271146,47271146,0.6924029955495401,0.05597060382367868,105.92890476190475
51,2010-07-30,Dinner for Schmucks,69000000,73026337,86796502,17796502,0.20503708778494323,0.05513540957148104,105.83527101449275
33,2009-09-09,9,30000000,31749894,48559999,18559999,0.38220756553145724,0.05511495565937952,105.83298
82,2006-12-20,Letters from Iwo Jima,13000000,13756082,67867998,54867998,0.8084516947147904,0.054963469976407525,105.81601538461538
30,2016-01-15,13 Hours: The Secret Soldiers of Benghazi,50000000,52853219,69411370,19411370,0.27965692076096466,0.05398382641556799,105.70643799999999
31,2002-05-08,Unfaithful,50000000,52752475,119114494,69114494,0.580235802370113,0.05217717272981031,105.50495
40,2005-12-14,King Kong,207000000,218080025,550517357,343517357,0.6239900570473748,0.05080715209932684,105.3526690821256
28,2007-04-20,In the Land of Women,10500000,11052958,14140402,3640402,0.25744685334971384,0.05002805583808425,105.26626666666668
86,2008-12-10,The Reader,32500000,34194407,112964875,80464875,0.7122999516442612,0.04955216799051377,105.21356
51,2005-04-08,Fever Pitch,40000000,42071069,50071069,10071069,0.20113549003717093,0.04922786725481114,105.17767250000001
88,2012-07-06,Savages,45000000,47323100,82513490,37513490,0.4546346300465536,0.04909019062571979,105.16244444444445
26,2001-08-13,K-PAX,48000000,50315140,50315140,2315140,0.04601279058351025,0.04601279058351025,104.82320833333334
91,2009-08-21,Shorts,20000000,20919166,29870801,9870801,0.33044982623666497,0.04393894096925279,104.59582999999999
70,2010-09-10,Resident Evil: Afterlife,57500000,60128566,295874190,238374190,0.8056606424507661,0.043715760658586136,104.57141913043478
45,2015-12-18,Saul fia,1700000,1777043,9696537,7996537,0.8246796768784567,0.043354606500799364,104.53194117647058
56,2001-07-13,The Score,68000000,71069884,113542091,45542091,0.40110315565705057,0.04319528648731156,104.51453529411765
52,2007-12-25,Aliens vs. Predator - Requiem,40000000,41797066,128884494,88884494,0.6896445898294019,0.04299502745001288,104.492665
21,2016-04-22,Compadres,3000000,3127773,7445044,4445044,0.5970473780947433,0.04085111035871209,104.2591
36,2004-11-19,La mala educaciÃ³n,5000000,5211842,40311842,35311842,0.8759669677212965,0.04064628206304029,104.23684
79,2012-11-02,The Man with the Iron Fists,15000000,15634090,22018988,7018988,0.31876978179015314,0.040558164881998246,104.22726666666667
80,2016-03-04,London Has Fallen,60000000,62524260,195194085,135194085,0.6926136363199735,0.040372489014664066,104.2071
52,2010-08-20,Piranha 3D,24000000,25003155,83660160,59660160,0.7131251004062149,0.04012113671254688,104.1798125
88,2012-11-21,Life of Pi,120000000,124987022,620912003,500912003,0.8067358990964779,0.039900318610679435,104.15585166666668
69,2018-09-28,Smallfoot,80000000,83240103,213691277,133691277,0.625628143913427,0.03892478364665166,104.05012875
15,2016-09-23,Storks,70000000,72679278,183353431,113353431,0.6182236698914022,0.0368644003315498,103.82754000000001
55,2016-09-23,The Magnificent Seven,90000000,93432655,162525156,72525156,0.4462395716759072,0.0367393498557865,103.81406111111112
28,2006-06-28,Strangers with Candy,2000000,2072645,2077844,77844,0.03746383270351383,0.03504941753170466,103.63225
21,2013-12-13,The Hobbit: The Desolation of Smaug,250000000,258366855,960366855,710366855,0.7396828111065953,0.03238362366565944,103.346742
5,2005-10-21,Dreamer: Inspired by a True Story,32000000,33022286,39498360,7498360,0.18983978068962867,0.030957457033713536,103.19464375
39,2009-05-22,Dance Flick,25000000,25794018,32224624,7224624,0.2241957578775783,0.030783028840252805,103.176072
78,2018-08-17,Mile 22,35000000,36108758,66295121,31295121,0.4720576797800852,0.0307060685942175,103.16788
8,2007-05-24,Pirates of the Caribbean: At Worldâs End,300000000,309420425,963420425,663420425,0.6886094666303135,0.030445388341768322,103.14014166666668
68,2002-05-24,Enough,38000000,39177215,50970660,12970660,0.2544730635232112,0.030048460565662974,103.0979342105263
75,2006-08-18,Snakes on a Plane,33000000,34020814,62020814,29020814,0.46792055970113516,0.030005572471017303,103.09337575757576
42,2014-10-17,The Best of Me,26000000,26766213,41059418,15059418,0.3667713458578492,0.028626126527499428,102.94697307692309
90,2014-05-23,Blended,45000000,46290741,127990741,82990741,0.6484120675572931,0.027883351446026754,102.86831333333333
65,2013-08-16,Kick-Ass 2,28000000,28795985,63129909,35129909,0.5564701352571251,0.027642221649997387,102.84280357142856
70,2006-02-10,The Pink Panther,80000000,82226474,158926474,78926474,0.49662257025849577,0.027077337646753526,102.7830925
46,2004-06-18,The Terminal,75000000,77073959,218673959,143673959,0.6570236330700905,0.026908686499418046,102.76527866666667
32,2017-09-29,American Made,50000000,51342000,135569212,85569212,0.6311846970092295,0.026138444158778387,102.684
11,2016-01-29,Kung Fu Panda 3,140000000,143528619,517599142,377599142,0.7295204171725617,0.02458477636435699,102.52044214285714
75,2015-05-15,Mad Max: Fury Road,150000000,153636354,370098020,220098020,0.5947019657116782,0.023668577815898963,102.424236
40,2001-04-20,Crocodile Dundee in Los Angeles,25000000,25590119,39393111,14393111,0.3653712701187779,0.023060424220770526,102.360476
52,2002-10-11,White Oleander,16000000,16357770,21657770,5657770,0.26123511331037313,0.0218715631776214,102.23606249999999
34,2019-04-05,The Best of Enemies,10000000,10205616,10205616,205616,0.020147338485006685,0.020147338485006685,102.05615999999999
22,2014-12-17,The Hobbit: The Battle of the Five Armies,250000000,255119788,945577621,695577621,0.7356113401503609,0.020068172838086554,102.0479152
76,2004-04-16,The Punisher,33000000,33664370,54533774,21533774,0.3948704155336838,0.019735108662363204,102.01324242424243
66,2007-10-12,We Own the Night,28000000,28563179,55307857,27307857,0.49374281487709787,0.01971695797586116,102.01135357142857
34,2014-07-02,Deliver Us from Evil,30000000,30577122,87956618,57956618,0.6589227657661871,0.01887430739884545,101.92374
35,2014-08-01,Get on Up,30000000,30569935,33339868,3339868,0.10017640141826596,0.01864364448272461,101.89978333333333
82,2006-03-10,The Shaggy Dog,60000000,61123569,87123569,27123569,0.3113229785157217,0.018381927272604123,101.872615
6,2010-11-05,127 Hours,18000000,18335230,60217171,42217171,0.7010819389041043,0.018283381228378373,101.8623888888889
26,2005-08-12,Deuce Bigalow: European Gigolo,22000000,22400154,45273464,23273464,0.5140641325788545,0.01786389504286444,101.81888181818182
59,2008-10-17,W.,25100000,25534493,28575778,3475778,0.12163371369976346,0.017015924302863583,101.73104780876494
33,2005-11-23,Syriana,50000000,50824620,92690959,42690959,0.46057306408923876,0.016224813879572537,101.64923999999999
34,2004-09-10,Resident Evil: Apocalypse,50000000,50740078,125168734,75168734,0.6005392209207773,0.014585669340122023,101.480156
23,2001-12-14,Iris,5500000,5580479,5580479,80479,0.014421521880111006,0.014421521880111008,101.46325454545455
56,2014-05-02,The Amazing Spider-Man 2,200000000,202853933,708996336,508996336,0.7179110951004971,0.014068906418491773,101.4269665
16,2013-11-01,Free Birds,55000000,55750480,110387072,55387072,0.5017532487862347,0.013461408762758635,101.36450909090908
47,2005-02-18,Constantine,75000000,75976178,221594911,146594911,0.6615445740087416,0.012848474689000544,101.30157066666668
53,2009-09-18,Jennifer's Body,16000000,16204793,31943401,15943401,0.49911407367048993,0.012637804136097264,101.27995625
49,2014-04-11,Rio 2,130000000,131538435,492846291,362846291,0.7362260762149065,0.011695707038022765,101.18341153846153
75,2012-06-08,Prometheus,125000000,126477084,402448265,277448265,0.6894010712159487,0.011678668999041755,101.18166719999999
13,2002-09-20,Secretary,4000000,4046737,9413956,5413956,0.5750989275921834,0.011549305032672002,101.16842500000001
93,2008-09-19,Appaloosa,20000000,20211394,27911453,7911453,0.2834482676340784,0.01045914992305825,101.05697
53,2007-12-25,The Water Horse: Legend of the Deep,40000000,40412817,103429755,63429755,0.6132640940704153,0.010215001839639143,101.0320425
94,2015-11-20,Secret in Their Eyes,20000000,20180155,32608019,12608019,0.3866539393270103,0.0089273347999557,100.90077500000001
76,2010-09-17,Incendies,6800000,6857096,16038343,9238343,0.5760160510346986,0.008326556898138803,100.83964705882353
30,2006-12-15,Charlotte's Web,82500000,82985708,143985708,61485708,0.42702646571005504,0.005852911443498199,100.58873696969697
71,2011-07-08,Zookeeper,80000000,80360866,170805525,90805525,0.5316310757512088,0.004490568829858056,100.45108250000001
16,2010-05-27,Sex and the City 2,95000000,95347692,294680778,199680778,0.6776172485875547,0.0036465696516282745,100.36599157894737
35,2014-10-17,The Book of Life,50000000,50151543,97651543,47651543,0.4879753205742996,0.003021701645351171,100.303086
37,2009-06-12,Moon,5000000,5010163,10676073,5676073,0.5316630000562941,0.0020284769178168455,100.20326
4,2006-09-29,Open Season,85000000,85105259,191932158,106932158,0.5571351831515383,0.0012368095842349765,100.12383411764705
81,2019-02-01,Miss Bala,15000000,14998027,15362298,362298,0.023583581050178822,-0.00013155063662707102,99.98684666666666
91,2017-06-16,All Eyez on Me,45000000,44922302,54876855,9876855,0.17998216187862806,-0.0017296086028716871,99.82733777777779
60,2009-10-02,The Invention of Lying,18500000,18451251,32679264,14179264,0.43389177920286087,-0.0026420430788134637,99.73649189189189
82,2012-11-30,Killing Them Softly,15000000,14945541,39238443,24238443,0.6177218346813609,-0.003643829286607959,99.63694
50,2009-11-25,The Princess and the Frog,105000000,104400899,270997378,165997378,0.6125423767015192,-0.00573846591110293,99.42942761904762
84,2004-04-02,Hellboy,60000000,59623958,99823958,39823958,0.3989418852736734,-0.0063068942856829464,99.37326333333333
72,2008-12-12,The Day the Earth Stood Still,80000000,79366978,237370350,157370350,0.6629739139702999,-0.007975886394464962,99.20872250000001
53,2002-04-05,High Crimes,42000000,41543207,63781100,21781100,0.34149771640815224,-0.010995612351256368,98.91239761904762
85,2006-08-11,Pulse,20500000,20264436,30241435,9741435,0.32212211490625364,-0.011624503144326346,98.85090731707317
95,2004-08-13,Yu-Gi-Oh,20000000,19762690,28762690,8762690,0.30465474543584065,-0.01200798069493576,98.81345
79,2015-05-08,Hot Pursuit,35000000,34580201,45671512,10671512,0.23365795290508445,-0.012139865815123515,98.80057428571428
80,2015-12-25,Concussion,35000000,34531832,50363790,15363790,0.30505627157924375,-0.01355757783137599,98.66237714285714
11,2018-05-18,First Reformed,3500000,3448256,3874772,374772,0.09672104578024204,-0.015005846433675458,98.52159999999999
53,2012-03-16,Casa de mi Padre,6000000,5909483,8446952,2446952,0.28968461049618843,-0.015317245180331342,98.49138333333333
6,2005-09-23,A History of Violence,32000000,31493782,61477797,29477797,0.47948687881577795,-0.016073585573177587,98.41806875
96,2007-03-23,Reign Over Me,20000000,19661987,20081987,81987,0.004082613936559166,-0.017191192324560078,98.30993500000001
81,2017-10-13,The Foreigner,35000000,34393507,140783360,105783360,0.7513910734905034,-0.017633938871078194,98.26716285714285
48,2006-07-21,Monster House,75000000,73661010,141267370,66267370,0.46909183628179674,-0.018177730661037637,98.21468
95,2003-12-19,Mona Lisa Smile,65000000,63803100,141205169,76205169,0.5396769080032757,-0.018759276586874304,98.15861538461539
27,2001-12-25,Kate and Leopold,48000000,47095453,70937778,22937778,0.32335066937112134,-0.01920667373132604,98.11552708333333
83,2009-05-29,MÃ¤n som hatar kvinnor,13000000,12749992,109421911,96421911,0.8811938131842717,-0.01960848289159711,98.07686153846153
22,2008-06-13,The Incredible Hulk,137500000,134806913,265573859,128073859,0.4822532589700404,-0.019977365700822775,98.04139127272727
85,2016-10-21,Jack Reacher: Never Go Back,60000000,58697076,159946489,99946489,0.6248745416349839,-0.02219742598421768,97.82845999999999
58,2018-03-09,A Wrinkle in Time,103000000,100478608,133401882,30401882,0.22789694975967428,-0.025093818974880704,97.55204660194174
42,2005-03-18,Ice Princess,25000000,24381334,25732334,732334,0.028459680338363394,-0.025374575484672004,97.525336
37,2006-02-10,Firewall,50000000,48751189,82751189,32751189,0.3957790745459862,-0.025616011129492657,97.50237800000001
31,2008-02-14,Jumper,82500000,80172128,222640812,140140812,0.6294479917725058,-0.02903592630097083,97.17833696969697
82,2004-12-03,Closer,35000000,33987757,116177695,81177695,0.6987373522946896,-0.029782577296877815,97.10787714285715
24,2006-02-24,Tsotsi,3000000,2912606,11537539,8537539,0.7399792104711412,-0.03000543156197577,97.08686666666667
2,2003-12-12,Girl with a Pearl Earring,12000000,11634362,43274797,31274797,0.7227023387307859,-0.03142742163257427,96.95301666666667
26,2014-03-07,300: Rise of an Empire,110000000,106580051,330780051,220780051,0.6674527388593939,-0.032088078096340934,96.89095545454546
81,2008-02-08,Fool's Gold,72500000,70231041,109362966,36862966,0.33706991816589904,-0.03230706775370167,96.87040137931035
53,2010-11-24,Faster,24000000,23240020,35792945,11792945,0.3294768005259137,-0.03270134879401997,96.83341666666666
86,2017-05-25,Baywatch,60000000,58060186,175863783,115863783,0.6588268546457914,-0.03341039933974721,96.76697666666666
52,2017-07-14,War for the Planet of the Apes,152000000,146880162,489592267,337592267,0.6895375800533222,-0.034857246412895435,96.63168552631579
89,2007-02-16,Ghost Rider,120000000,115802596,229545589,109545589,0.47722802898207717,-0.03624619952388632,96.50216333333333
23,2003-06-20,Hulk,137000000,132177234,245075434,108075434,0.4409884427665646,-0.03648711547406114,96.47973284671532
54,2017-09-22,Kingsman: The Golden Circle,104000000,100234838,408803696,304803696,0.7455991689468483,-0.03756340684662951,96.37965192307692
54,2014-07-18,Sex Tape,40000000,38543473,126069509,86069509,0.6827147157366973,-0.03778919974336511,96.3586825
43,2011-08-26,Don't Be Afraid of the Dark,25000000,24046682,39126427,14126427,0.36104566869855,-0.039644471532496665,96.186728
97,2008-09-19,My Best Friend's Girl,20000000,19219250,34787111,14787111,0.42507441908585053,-0.04062333337669264,96.09625000000001
39,2016-12-02,Incarnate,5000000,4799774,9371036,4371036,0.46644106372016914,-0.04171571411487291,95.99548
36,2017-12-25,Mollyâs Game,30000000,28780744,53296424,23296424,0.4371104522885062,-0.04236360255315151,95.93581333333333
21,2017-08-18,Logan Lucky,29000000,27778642,44264271,15264271,0.3448440617038514,-0.04396752008251519,95.78842068965517
57,2011-06-24,Cars 2,200000000,191450875,560155383,360155383,0.6429562116695753,-0.04465440547085512,95.7254375
23,2009-09-11,Sorority Row,12500000,11965282,26735797,14235797,0.5324620395644087,-0.04468912642426647,95.72225599999999
37,2012-04-27,The Five-Year Engagement,30000000,28700285,61623819,31623819,0.5131752545229304,-0.04528578723172958,95.66761666666666
55,2011-04-15,Scream 4,40000000,38180928,95989590,55989590,0.5832881461416806,-0.04764347267829635,95.45232
56,2015-12-18,Alvin and the Chipmunks: The Road Chip,90000000,85886987,249517956,159517956,0.6393045156237173,-0.04788866327328493,95.42998555555555
40,2014-08-08,Into the Storm,50000000,47602194,150429371,100429371,0.6676181009890683,-0.05037175387336138,95.204388
40,2018-01-26,Maze Runner: The Death Cure,61000000,58032443,265878536,204878536,0.7705719276263805,-0.05113617222697311,95.1351524590164
25,2010-04-09,Letters to God,3000000,2848587,3237452,237452,0.07334533454086732,-0.053153721476647896,94.9529
17,2003-12-10,Big Fish,70000000,66432867,123954323,53954323,0.4352758475394198,-0.053695304163223906,94.90409571428572
9,2016-01-15,Norm of the North,18000000,17062499,30535660,12535660,0.4105252678343943,-0.05494511677334018,94.79166111111111
59,2009-07-01,Public Enemies,102500000,97104620,212282709,109782709,0.5171533259451668,-0.05556254686955162,94.73621463414634
4,2017-04-21,Unforgettable,12000000,11368012,16221211,4221211,0.2602278584502723,-0.05559353737487258,94.73343333333332
18,2008-04-18,The Forbidden Kingdom,55000000,52075270,129075270,74075270,0.5738920398926921,-0.05616351101012054,94.68230909090909
22,2016-08-12,Florence Foster Jenkins,29000000,27383770,56000339,27000339,0.48214599200908403,-0.05902145687025563,94.42679310344828
98,2007-05-11,Georgia Rule,20000000,18882880,20819601,819601,0.03936679670278023,-0.05916046704739955,94.4144
44,2010-04-23,The Losers,25000000,23591432,29863840,4863840,0.16286719993142207,-0.05970676133606472,94.365728
29,2005-02-11,Bride & Prejudice,7000000,6601079,25269040,18269040,0.7229811658852099,-0.06043269592743853,94.30112857142858
27,2017-05-19,Diary of a Wimpy Kid: The Long Haul,22000000,20738724,35609577,13609577,0.3821886735694726,-0.06081743505531006,94.26692727272727
41,2014-10-10,The Judge,50000000,47119388,76119388,26119388,0.3431371255901322,-0.061134325428844706,94.238776
88,2015-12-25,Joy,60000000,56451232,101134059,41134059,0.40672805389923083,-0.06286431445818579,94.08538666666666
42,2006-04-21,Silent Hill,50000000,46982632,94704227,44704227,0.4720404612985226,-0.06422305161618021,93.965264
28,2008-01-18,Mad Money,22000000,20668843,25044057,3044057,0.12154807825265693,-0.06440404041967904,93.94928636363636
11,2011-11-11,Jack and Jill,79000000,74158157,150519217,71519217,0.4751500733623934,-0.0652907676764405,93.87108481012658
4,2002-04-26,Jason X,14000000,13121555,16951798,2951798,0.17412890361246636,-0.06694671477580211,93.72539285714285
58,2011-03-18,Paul,40000000,37412945,101162106,61162106,0.6045950249394768,-0.0691486596417363,93.5323625
17,2010-02-12,Percy Jackson & the Olympians: The Lightning Thief,95000000,88768303,223050874,128050874,0.5740881965788666,-0.07020182643347367,93.44031894736841
57,2001-06-08,Atlantis: The Lost Empire,90000000,84052762,186049020,96049020,0.5162565220714411,-0.0707560091838505,93.39195777777778
89,2012-08-17,ParaNorman,60000000,56003051,108119662,48119662,0.44505930845399794,-0.07137020088423397,93.33841833333332
27,2004-12-17,The Aviator,110000000,102608827,208370892,98370892,0.47209517152712477,-0.07203252601260124,93.28075181818181
19,2004-12-22,The Phantom of the Opera,55000000,51225796,153770052,98770052,0.6423230708148554,-0.07367780092670498,93.13781090909092
20,2018-11-30,Werk ohne Autor,1400000,1303747,4331152,2931152,0.6767603630627602,-0.0738279742925583,93.12478571428572
20,2014-03-21,Muppets Most Wanted,55000000,51178893,79312301,24312301,0.30653884319911484,-0.0746617751188952,93.05253272727273
76,2019-05-10,PokÃ©mon: Detective Pikachu,150000000,139507806,411258433,261258433,0.6352658378193062,-0.07520865176533563,93.00520399999999
67,2014-09-19,A Walk Among the Tombstones,28000000,26017685,62108587,34108587,0.5491766702082596,-0.07619106004242883,92.92030357142858
86,2002-12-27,The Pianist,35000000,32519322,111854182,76854182,0.6870926113428643,-0.07628320172234833,92.91234857142857
97,2004-11-12,Kinsey,11000000,10214647,17443529,6443529,0.36939365881754777,-0.0768849868233332,92.86042727272728
77,2003-11-05,The Matrix Revolutions,150000000,139270910,427300260,277300260,0.6489587907107756,-0.07703755220670275,92.84727333333333
59,2012-12-19,The Guilt Trip,40000000,37134215,41294674,1294674,0.031352081868959665,-0.07717370624368927,92.8355375
44,2003-11-21,The Cat in the Hat,109000000,101018283,133818283,24818283,0.18546257240499792,-0.07901259814522882,92.677323853211
45,2009-04-24,Fighting,25000000,23091010,32831707,7831707,0.23854096285642412,-0.08267243399054437,92.36404
58,2008-12-25,Valkyrie,90000000,83107829,203932174,113932174,0.5586767981005293,-0.08293046615379641,92.34203222222223
84,2011-08-19,One Day,15000000,13843771,59168692,44168692,0.7464875512205001,-0.08351980107154329,92.29180666666666
32,2008-07-11,Hellboy II: The Golden Army,82500000,75986503,160388063,77888063,0.4856225678091766,-0.08571913093566104,92.10485212121212
5,2004-12-03,House of Flying Daggers,12000000,11050094,92863945,80863945,0.8707786967267005,-0.08596361261723204,92.08411666666667
69,2016-01-22,The 5th Wave,38000000,34912982,111336398,73336398,0.658692029896638,-0.0884203474799145,91.87626842105263
5,2011-11-04,Tower Heist,85000000,78046570,150422946,65422946,0.4349266367911715,-0.0890933451655851,91.81949411764705
78,2018-03-29,Ready Player One,150000000,137690172,579290136,429290136,0.7410623957180588,-0.08940237216059255,91.793448
1,2007-09-21,Into the Wild,20000000,18354356,56822960,36822960,0.648029599302817,-0.08965958816533798,91.77178
96,2012-05-16,The Dictator,65000000,59650222,180148897,115148897,0.6391873551132539,-0.08968580200757677,91.7695723076923
60,2011-08-26,Colombiana,40000000,36665854,72295262,32295262,0.44671339596224163,-0.09093326995738324,91.664635
29,2013-11-27,Homefront,22000000,20158492,51695362,29695362,0.574429907270985,-0.09135147609255692,91.6295090909091
22,2006-07-14,Little Man,64000000,58636047,101636047,37636047,0.3703021527391753,-0.09147876220237015,91.6188234375
87,2005-05-06,House of Wax,35000000,32064800,70064800,35064800,0.500462429065665,-0.09153963224470447,91.61371428571428
75,2002-05-24,Spirit: Stallion of the Cimarron,80000000,73215310,106515310,26515310,0.24893426118742934,-0.0926676401424784,91.5191375
42,2011-06-03,X-Men: First Class,160000000,146408305,355408305,195408305,0.5498135588024596,-0.09283418041073557,91.505190625
18,2012-08-10,The Campaign,95000000,86907746,104907746,9907746,0.0944424637623994,-0.09311315012127917,91.48183789473684
29,2011-03-04,Rango,135000000,123477607,245724600,110724600,0.4506044571849949,-0.09331564872325393,91.46489407407408
19,2012-06-01,Snow White and the Huntsman,170000000,155136755,401021746,231021746,0.5760828391585527,-0.09580737330750537,91.25691470588235
50,2010-07-23,Salt,130000000,118311368,290650494,160650494,0.552727407371962,-0.09879551050411318,91.00874461538461
28,2016-12-21,Passengers,110000000,100014699,302239672,192239672,0.6360504255708694,-0.09983833476317316,90.92245363636363
62,2018-01-12,The Commuter,40000000,36343858,101985431,61985431,0.6077871161813299,-0.10059862109300559,90.859645
78,2017-03-10,Kong: Skull Island,185000000,168052812,561072059,376072059,0.6702740814972574,-0.10084441788453977,90.83935783783784
73,2012-02-17,Ghost Rider: Spirit of Vengeance,57000000,51774002,149217355,92217355,0.6180069000686951,-0.1009386525692953,90.83158245614035
76,2012-08-10,The Bourne Legacy,125000000,113203870,280355920,155355920,0.5541381826358438,-0.10420253300527624,90.563096
3,2005-02-11,Pooh's Heffalump Movie,20000000,18098433,55686944,35686944,0.6408493883234102,-0.10506804649883225,90.492165
48,2012-10-05,Frankenweenie,39000000,35287788,81150788,42150788,0.5194131694691615,-0.10519820624630821,90.4815076923077
43,2004-03-12,Agent Cody Banks 2: Destination London,26000000,23514247,28703083,2703083,0.09417396033729199,-0.10571263455725374,90.43941153846153
23,2017-04-14,The Fate of the Furious,250000000,225764765,1234846267,984846267,0.7975456486519872,-0.1073472868983785,90.30590600000001
88,2001-10-19,From Hell,35000000,31598308,68712365,33712365,0.4906302526481224,-0.10765424528427281,90.28088
51,2008-03-07,"10,000 B.C.",105000000,94784201,269065678,164065678,0.6097607068263831,-0.10777955494924729,90.27066761904761
79,2005-11-04,Chicken Little,150000000,135386665,310043823,160043823,0.5161974247750132,-0.10793777215798912,90.25777666666667
31,2008-01-25,Rambo,47500000,42754105,112214531,64714531,0.5767036623804095,-0.11100442869754845,90.00864210526316
46,2007-08-24,War,25000000,22486409,40686409,15686409,0.3855441997842572,-0.11178267726074004,89.945636
89,2018-06-01,Adrift,35000000,31445011,57897191,22897191,0.39548017105009464,-0.11305415030702326,89.84288857142857
29,2011-01-14,The Green Hornet,110000000,98780042,229155503,119155503,0.5199766160535975,-0.11358527262015135,89.80003818181818
55,2011-03-11,Red Riding Hood,42000000,37662162,91678442,49678442,0.5418770314617694,-0.11517761513531805,89.67181428571429
91,2003-12-25,Paycheck,60000000,53789313,98819789,38819789,0.39283416199158255,-0.11546321478394789,89.64885500000001
11,2013-08-16,Jobs,18000000,16131410,43402515,25402515,0.58527748910403,-0.11583550353006959,89.61894444444445
10,2001-11-02,The One,49000000,43905746,72689126,23689126,0.3258964208759368,-0.11602704575387468,89.60356326530612
60,2014-12-19,Night at the Museum: Secret of the Tomb,127000000,113746621,353756621,226756621,0.6409961186281231,-0.1165166831637135,89.564268503937
54,2011-07-29,The Guard,6000000,5359774,21197454,15197454,0.716947139029055,-0.11945018577275833,89.32956666666666
100,2011-01-28,The Rite,37000000,33047633,97143987,60143987,0.6191220770051367,-0.11959606910425324,89.31792702702703
32,2008-05-02,Son of Rambow: A Home Movie,2000000,1785505,11263263,9263263,0.8224315635708764,-0.12013127938594403,89.27525
4,2016-07-15,Ghostbusters,144000000,128350574,229008658,85008658,0.37120281277749767,-0.12192719917247896,89.13234305555555
19,2012-01-20,Underworld: Awakening,70000000,62321039,160379930,90379930,0.5635364100732554,-0.1232161902820651,89.03005571428572
80,2006-05-05,Mission: Impossible III,150000000,133501348,397501348,247501348,0.6226427891258371,-0.12358416036368412,89.00089866666666
39,2011-07-15,Winnie the Pooh,30000000,26692846,50145607,20145607,0.4017422104392913,-0.12389664256857437,88.97615333333333
81,2009-05-15,Angels & Demons,150000000,133375846,490875846,340875846,0.6944237504812979,-0.12464141370844613,88.91723066666667
85,2004-06-25,De-Lovely,15000000,13337299,18524496,3524496,0.19026137067372845,-0.12466549636474372,88.91532666666667
50,2007-12-21,Charlie Wilson's War,75000000,66661095,119512771,44512771,0.3724520034766828,-0.12509402973353498,88.88146
82,2004-05-14,Troy,150000000,133298577,484161265,334161265,0.6901858722630362,-0.12529333302635332,88.865718
30,2008-09-19,Igor,22000000,19528602,31013349,9013349,0.2906280453620149,-0.1265527353161276,88.76637272727272
30,2002-11-29,Rabbit-Proof Fence,7000000,6199600,16866928,9866928,0.5849866674002522,-0.12910510355506807,88.56571428571428
20,2003-07-01,Terminator 3: Rise of the Machines,170000000,150358296,433058296,263058296,0.6074431512564765,-0.13063265893888557,88.44605647058823
39,2013-01-25,Movie 43,10000000,8840453,31164747,21164747,0.6791246211624951,-0.13116375371262085,88.40453000000001
40,2018-10-19,Can You Ever Forgive Me?,10000000,8803865,11752387,1752387,0.1491090278085635,-0.13586475939828702,88.03864999999999
31,2001-02-09,Saving Silverman,22000000,19351569,25873142,3873142,0.14969739662851925,-0.13685872189484996,87.96167727272727
83,2010-07-01,The Last Airbender,150000000,131772187,319713881,169713881,0.5308305052916986,-0.1383282270332206,87.84812466666668
9,2008-02-22,Die FÃ¤lscher,6250000,5488570,20199663,13949663,0.6905888974484377,-0.13873012460440515,87.81712
90,2008-08-15,Mirrors,35000000,30691439,77220596,42220596,0.546753045003693,-0.14038315375176771,87.68982571428572
5,2012-10-26,Silent Hill: Revelation 3D,20000000,17530219,55975672,35975672,0.6427019223637012,-0.14088705908351745,87.651095
57,2014-10-03,Left Behind,16000000,14019924,20769209,4769209,0.22962882216650624,-0.14123300525737514,87.62452499999999
5,2004-07-09,Riding Giants,2600000,2276368,3292333,692333,0.21028644429345392,-0.14217033449776134,87.55261538461538
59,2015-07-24,Pixels,90000000,78765986,244041804,154041804,0.6312107248641712,-0.14262519357022968,87.51776222222222
13,2013-03-27,G.I. Joe: Retaliation,140000000,122523060,375740705,235740705,0.62740262596782,-0.14264204632172914,87.51647142857144
5,2017-06-16,Cars 3,175000000,152901115,383541369,208541369,0.5437258816271264,-0.1445305680079573,87.37206571428572
60,2001-06-29,Artificial Intelligence: AI,90000000,78616689,235900000,145900000,0.6184824077999153,-0.1447950956062268,87.35187666666666
48,2005-04-22,A Lot Like Love,25000000,21835784,41921590,16921590,0.4036485734438985,-0.1449096583846039,87.343136
93,2016-05-27,X-Men: Apocalypse,178000000,155442489,542537546,364537546,0.6719121076276627,-0.14511805070234046,87.32724101123596
22,2016-08-19,Kubo and the Two Strings,55000000,48023088,77548122,22548122,0.2907629665100078,-0.14528245247369348,87.31470545454545
33,2015-12-25,The Hateful Eight,62000000,54117416,147864886,85864886,0.5806982869482616,-0.14565706537060083,87.28615483870968
7,2017-03-31,The Zookeeperâs Wife,20000000,17445186,26308749,6308749,0.23979661670724065,-0.14644808028988626,87.22592999999999
76,2001-06-08,Swordfish,80000000,69772969,147080413,67080413,0.4560798520466488,-0.1465758322538919,87.21621125
86,2009-10-02,Whip It,15000000,13077184,18889972,3889972,0.20592788597039738,-0.14703593678883772,87.18122666666666
86,2005-11-04,Jarhead,72000000,62647540,96947540,24947540,0.2573303046162904,-0.14928694726081823,87.01047222222222
12,2001-10-26,Life as a House,18000000,15652637,23889158,5889158,0.24652011594548454,-0.1499659769788311,86.95909444444445
68,2010-01-15,The Spy Next Door,28000000,24307106,46752858,18752858,0.401106131308593,-0.1519265189364789,86.81109285714285
91,2017-01-06,Underworld: Blood Wars,35000000,30353973,81209222,46209222,0.569014464884296,-0.1530615778039995,86.72563714285715
15,2004-03-05,Hidalgo,78000000,67286731,108086731,30086731,0.27835730363609573,-0.15921815253589894,86.26503974358974
24,2006-06-28,Superman Returns,232000000,200120000,374085065,142085065,0.3798202021243483,-0.15930441734959025,86.25862068965517
13,2016-12-16,Collateral Beauty,36000000,31016021,85309093,49309093,0.5780051254325257,-0.16069047025729058,86.1556138888889
38,2008-09-26,Choke,3400000,2926565,4124277,724277,0.17561308321434274,-0.16177156495755263,86.07544117647059
45,2016-08-19,War Dogs,50000000,43034523,86234503,36234503,0.42018567672385143,-0.16185788791013206,86.069046
58,2010-12-17,Tron: Legacy,200000000,172062763,400062763,200062763,0.5000784414419495,-0.16236654876918372,86.03138150000001
88,2008-01-23,U2 3D,15000000,12898847,26170402,11170402,0.4268334127996964,-0.16289463701678142,85.99231333333334
79,2016-07-22,Star Trek Beyond,185000000,158848340,335802233,150802233,0.44908049494715546,-0.1646328819048408,85.86396756756757
19,2010-11-12,Unstoppable,95000000,81562942,165720921,70720921,0.42674709127401,-0.16474464592020233,85.85572842105263
6,2009-08-07,G.I. Joe: The Rise of Cobra,175000000,150201498,302469017,127469017,0.42142834417979413,-0.1651015624358154,85.82942742857142
92,2016-11-04,Loving,9000000,7710234,12898064,3898064,0.3022208604330076,-0.16727974792982936,85.66926666666667
9,2005-04-08,Kung Fu Hustle,20000000,17104669,102034104,82034104,0.8039871061150299,-0.16927138432202343,85.52334499999999
62,2001-11-02,Domestic Disturbance,53000000,45207112,54207112,1207112,0.02226851709052495,-0.17238190309524748,85.29643773584905
90,2017-01-20,The Founder,15000000,12786053,24403192,9403192,0.38532631304953874,-0.17315327881090434,85.24035333333333
16,2003-07-11,The League of Extraordinary Gentlemen,78000000,66465204,179265204,101265204,0.5648904625127361,-0.17354638676802978,85.21180000000001
16,2014-09-12,The Drop,12600000,10724389,19054534,6454534,0.33874006050213556,-0.1748921080725438,85.11419841269841
81,2012-08-17,The Expendables 2,100000000,85028192,311979256,211979256,0.6794658680768185,-0.1760805169184357,85.028192
6,2002-03-22,Sorority Boys,12000000,10198766,12516222,516222,0.04124423488173987,-0.17661293532962713,84.98971666666667
13,2010-01-08,Youth in Revolt,18000000,15285588,19685588,1685588,0.08562548398351119,-0.17757982224825108,84.91993333333333
93,2008-12-19,The Tale of Despereaux,60000000,50877145,90482317,30482317,0.33688700743593913,-0.17931145704028792,84.79524166666667
94,2014-09-26,The Boxtrolls,60000000,50837305,111946251,51946251,0.4640285006060631,-0.18023565568631145,84.72884166666667
20,2017-09-22,The Lego Ninjago Movie,70000000,59281555,122737201,52737201,0.429675767170216,-0.18080573291304522,84.68793571428571
95,2017-08-04,The Dark Tower,60000000,50701325,113461527,53461527,0.4711863872588282,-0.18340102551560536,84.50220833333333
100,2015-06-12,Me and Earl and the Dying Girl,8000000,6758416,9266180,1266180,0.13664530583260848,-0.18370931886998373,84.48020000000001
84,2007-11-02,Bee Movie,150000000,126631277,287594577,137594577,0.4784324462418496,-0.18454147785305838,84.42085133333333
11,2017-09-29,Flatliners,20000000,16883115,45173738,25173738,0.5572648869571077,-0.18461551674557686,84.415575
96,2002-09-27,The Tuxedo,60000000,50586000,104429625,44429625,0.42545039302784055,-0.1860989206499822,84.31
97,2014-01-17,Jack Ryan: Shadow Recruit,60000000,50577412,131377412,71377412,0.5433004876058908,-0.18630031920178122,84.29568666666667
98,2012-02-17,This Means War,65000000,54760791,156974557,91974557,0.5859201564747847,-0.18698066286149884,84.24737076923077
61,2003-11-26,The Haunted Mansion,90000000,75817994,155750628,65750628,0.4221532127626477,-0.18705330030230027,84.24221555555556
90,2018-04-13,Rampage,120000000,101028233,428056280,308056280,0.7196630312257071,-0.18778678431404416,84.19019416666667
91,2003-06-27,Charlie's Angels: Full Throttle,120000000,100814328,227200000,107200000,0.4718309859154929,-0.1903069968387827,84.01194
56,2002-01-25,The Mothman Prophecies,42000000,35228696,56438555,14438555,0.25582786448022987,-0.19220989615965348,83.87784761904761
70,2009-02-06,Push,38000000,31811527,49678401,11678401,0.23508005018116424,-0.19453555310312518,83.7145447368421
82,2012-02-17,Kari gurashi no Arietti,23000000,19192510,151496097,128496097,0.8481809072612608,-0.19838416132126543,83.44569565217391
93,2010-08-20,Nanny McPhee and the Big Bang,35000000,29197642,97799865,62799865,0.6421262953686082,-0.19872693829179766,83.42183428571428
2,2006-04-07,Lucky Number Slevin,27000000,22495466,55495466,28495466,0.5134737673884926,-0.20024186207122804,83.31654074074073
62,2005-09-16,Just Like Heaven,58000000,48318130,100687083,42687083,0.4239578874283209,-0.20037758083766902,83.30712068965516
35,2012-05-25,Men in Black 3,215000000,179020854,654213485,439213485,0.6713611001155074,-0.2009774012138273,83.2655134883721
59,2009-11-13,2012,200000000,166112167,757677748,557677748,0.7360355368388092,-0.2040057246378587,83.0560835
12,2007-03-16,Dead Silence,20000000,16574590,20614661,614661,0.029816692110532405,-0.20666634891119479,82.87295
99,2015-02-27,Focus,65000000,53862963,168065700,103065700,0.6132464863443284,-0.2067661409566347,82.86609692307692
67,2011-04-08,Arthur,40000000,33035397,47787943,7787943,0.1629687848250761,-0.2108224399422232,82.5884925
79,2004-07-30,The Manchurian Candidate,80000000,65948711,96148711,16148711,0.1679555641676777,-0.21306389142313942,82.43588875
83,2012-01-20,Haywire,23000000,18942396,36374700,13374700,0.3676923795935087,-0.21420753742029255,82.35824347826087
49,2003-10-03,Out of Time,50000000,41083108,55489826,5489826,0.09893391988650317,-0.21704521478754724,82.166216
68,2008-03-21,Drillbit Taylor,40000000,32862104,49686263,9686263,0.19494851122130075,-0.21720751659723309,82.15526
94,2006-09-01,Lage Raho Munna Bhai,2700000,2217561,31517561,28817561,0.9143334726947939,-0.21755388014129037,82.1318888888889
93,2006-03-03,16 Blocks,45000000,36895141,65595141,20595141,0.31397357618302857,-0.21967280190093325,81.98920222222222
94,2008-01-25,Untraceable,35000000,28687835,52649951,17649951,0.3352320498835792,-0.22002932601919942,81.96524285714287
94,2018-08-10,The Meg,178000000,145443742,529530715,351530715,0.6638533045245544,-0.2238408992529909,81.70996741573033
33,2001-09-14,The Glass House,22000000,17951431,22861785,861785,0.03769543804213013,-0.2255290399968671,81.59741363636364
83,2002-04-19,Nueve Reinas,1500000,1222889,12412889,10912889,0.8791578656668887,-0.22660355927643475,81.52593333333333
1,2008-07-18,Space Chimps,37000000,30105968,67029956,30029956,0.4480079921281763,-0.22899220513354696,81.36748108108108
13,2003-11-21,21 Grams,20000000,16248701,59667625,39667625,0.6648098529143734,-0.2308676244334855,81.243505
43,2003-07-18,Dirty Pretty Things,10000000,8112414,14156753,4156753,0.29362333297755494,-0.23267870697920495,81.12414
99,2005-03-24,Miss Congeniality 2: Armed and Fabulous,60000000,48478006,101382396,41382396,0.40818127833554063,-0.23767466838466914,80.79667666666667
63,2005-04-22,The Interpreter,90000000,72708161,162753837,72753837,0.4470176454273087,-0.2378252834643968,80.78684555555556
100,2004-12-08,Blade: Trinity,65000000,52397389,131353165,66353165,0.5051508656072353,-0.24051982819220247,80.6113676923077
50,2004-11-12,Bridget Jones: The Edge Of Reason,50000000,40203020,263894551,213894551,0.8105303811293929,-0.243687663265098,80.40604
8,2006-11-17,Bobby,14000000,11242801,20597806,6597806,0.3203159598648517,-0.24524128818076563,80.30572142857143
96,2011-09-23,Abduction,35000000,28087155,86648359,51648359,0.5960685187355943,-0.2461212251650265,80.24901428571428
11,2002-12-20,Gangs of New York,97000000,77730500,183124621,86124621,0.470306070967923,-0.24790140292420607,80.13453608247423
80,2006-11-22,DÃ©jÃ Vu,80000000,64038616,181038616,101038616,0.5581053270977282,-0.24924623605232193,80.04827
21,2014-10-10,Dracula Untold,70000000,55991880,220241723,150241723,0.6821673975007906,-0.2501812762850613,79.9884
14,2009-12-04,Armored,20000000,15988876,23661038,3661038,0.15472854572145145,-0.25086966713607634,79.94438000000001
60,2018-11-16,Fantastic Beasts: The Crimes of Grindelwald,200000000,159555901,652220086,452220086,0.6933550433465184,-0.25347918031561867,79.7779505
81,2019-06-07,The Secret Life of Pets 2,80000000,63795655,113351496,33351496,0.29423075280806177,-0.2540038972873623,79.74456875
100,2018-12-25,Vice,60000000,47836282,70883171,10883171,0.1535367400535735,-0.25427808122713214,79.72713666666667
69,2016-12-21,Patriots Day,40000000,31886361,52837989,12837989,0.24296891768534187,-0.25445484356148385,79.7159025
43,2008-12-25,The Curious Case of Benjamin Button,160000000,127509326,329631958,169631958,0.5146101701704542,-0.2548101775708547,79.69332875
85,2009-07-24,G-Force,150000000,119436770,292817841,142817841,0.48773613148797174,-0.25589464617973173,79.62451333333334
70,2011-12-25,Extremely Loud and Incredibly Close,40000000,31847881,55247881,15247881,0.2759903316472898,-0.2559705306610509,79.6197025
14,2003-12-05,The Last Samurai,140000000,111110575,456810575,316810575,0.6935272350032615,-0.26000607952933374,79.36469642857142
30,2016-09-30,Miss Peregrineâs Home for Peculiar Children,110000000,87242834,295986876,185986876,0.6283619007485994,-0.26084854144009123,79.31166727272728
72,2008-11-26,Transporter 3,40000000,31715062,107235592,67235592,0.6269895166895707,-0.2612303895228078,79.287655
82,2005-06-24,Bewitched,80000000,63313159,131159306,51159306,0.3900547171239226,-0.26356039192421277,79.14144875
43,2011-02-25,Des Hommes et Des Dieux,5000000,3954651,46263525,41263525,0.8919234969665627,-0.26433407145156423,79.09302
15,2007-12-14,The Kite Runner,20000000,15800078,74180745,54180745,0.7303882564134399,-0.265816535842418,79.00039
15,2005-12-21,Fun With Dick And Jane,140000000,110550000,203018919,63018919,0.31040909542031403,-0.2663952962460425,78.96428571428571
22,2006-09-29,The Guardian,70000000,55011732,94973540,24973540,0.26295260764208644,-0.27245584632747066,78.58818857142857
52,2005-06-10,The Adventures of Sharkboy and Lavagirl in 3-D,50000000,39177684,69425966,19425966,0.27980836449578533,-0.276236747429991,78.355368
2,2007-03-23,Shooter,60000000,47003582,95538560,35538560,0.371981323561921,-0.2764984592025348,78.33930333333333
56,2008-08-29,College,6000000,4694491,6176114,176114,0.02851534152381254,-0.2780938338149972,78.24151666666667
50,2011-02-11,The Eagle,25000000,19490041,38993548,13993548,0.35886829277499965,-0.2827063832241297,77.96016399999999
20,2009-03-06,Watchmen,138000000,107509799,186976250,48976250,0.26193834778481223,-0.28360392525708283,77.90565144927535
87,2007-08-10,Rush Hour 3,180000000,140125968,256585882,76585882,0.2984804986269666,-0.28455847669862305,77.84776
51,2014-03-28,Noah,130000000,101200044,352831065,222831065,0.6315517172502937,-0.2845844217221882,77.8461876923077
57,2006-09-22,La science des rÃªves,6000000,4670644,15137932,9137932,0.6036446722048956,-0.28461942293182696,77.84406666666666
12,2018-05-25,Solo: A Star Wars Story,275000000,213767512,393151347,118151347,0.3005238260063751,-0.2864443124547382,77.73364072727273
84,2013-04-19,The Lords of Salem,1500000,1165881,1541131,41131,0.026688840857785612,-0.28658070592110174,77.7254
31,2011-10-07,Real Steel,110000000,85463309,263880341,153880341,0.5831443919499861,-0.2871020474997054,77.69391727272728
58,2012-06-22,To Rome with Love,21500000,16684352,74326015,52826015,0.7107338527432151,-0.288632606168942,77.60163720930233
92,2013-08-09,Elysium,120000000,93050117,286192091,166192091,0.5807012011383641,-0.289627610032989,77.54176416666667
73,2010-11-10,Morning Glory,40000000,31011732,59795070,19795070,0.3310485295861348,-0.2898344407206924,77.52933
51,2015-08-05,Shaun the Sheep,25000000,19375982,101925161,76925161,0.7547219964656224,-0.29025718541646045,77.503928
74,2005-11-09,Get Rich or Die Tryin',40000000,30981850,46666955,6666955,0.1428624387427892,-0.29107848627502875,77.454625
45,2011-02-04,Sanctum,30000000,23209310,108957098,78957098,0.7246622702818315,-0.29258474293290065,77.36436666666665
15,2010-11-24,Tangled,260000000,200821936,586477240,326477240,0.5566750382333677,-0.2946792824465152,77.23920615384615
63,2013-06-07,The Internship,58000000,44672764,93672764,35672764,0.38082322413375136,-0.29833023092101485,77.02200689655172
32,2008-02-14,The Spiderwick Chronicles,92500000,71195053,162839667,70339667,0.43195658831702227,-0.29924757553028297,76.96762486486487
1,2014-03-07,Mr. Peabody & Sherman,145000000,111506430,269806430,124806430,0.4625776709621042,-0.3003734403477898,76.90098620689655
4,2013-01-11,Gangster Squad,60000000,46000903,104100903,44100903,0.42363612350221397,-0.30432222167464845,76.66817166666667
12,2017-05-19,Alien: Covenant,97000000,74262031,238521247,141521247,0.5933276334078532,-0.30618566034101596,76.55879484536082
7,2012-03-30,Mirror Mirror,85000000,64935167,173613482,88613482,0.5104066860429652,-0.30899794251703394,76.39431411764706
9,2017-11-17,Justice League,300000000,229024295,655945209,355945209,0.5426447272061713,-0.30990469810200705,76.34143166666667
54,2009-11-25,Ninja Assassin,50000000,38122883,62209892,12209892,0.1962693007086397,-0.31154823731458087,76.245766
70,2013-05-10,The Great Gatsby,190000000,144840419,351040419,161040419,0.458751785503082,-0.3117885277589538,76.23179947368422
64,2013-08-07,Percy Jackson: Sea of Monsters,90000000,68559554,200859554,110859554,0.5519257201975067,-0.3127273260849976,76.17728222222222
98,2008-03-28,Superhero Movie,35000000,26638520,73026302,38026302,0.5207206302189586,-0.313886807525343,76.11005714285714
6,2010-10-08,Nowhere Boy,1900000,1445366,7785229,5885229,0.755948090929631,-0.3145459350780356,76.07189473684211
14,2017-12-15,Ferdinand,111000000,84410380,289847930,178847930,0.6170405633050406,-0.31500414996354714,76.0453873873874
86,2008-11-21,Bolt,150000000,114053579,328015029,178015029,0.5427038801932457,-0.31517135468409985,76.03571933333333
45,2015-03-27,While We're Young,10000000,7582065,17503828,7503828,0.42869639715381114,-0.3189019086488971,75.82065
46,2008-02-01,Over Her Dead Body,10000000,7570127,21596074,11596074,0.5369528739344013,-0.320981801230019,75.70127
75,2019-05-03,Long Shot,40000000,30202860,43711031,3711031,0.08489918711823567,-0.3243778900408769,75.50715
46,2006-07-21,My Super Ex-Girlfriend,30000000,22530295,60772856,30772856,0.5063585624476822,-0.33154048804065817,75.10098333333333
5,2017-04-07,Smurfs: The Lost Village,60000000,45020282,197578586,137578586,0.6963233657315474,-0.3327326559171708,75.03380333333334
83,2006-12-15,Eragon,100000000,75030163,249488115,149488115,0.5991793035912752,-0.3327973177933786,75.030163
25,2017-05-26,Pirates of the Caribbean: Dead Men Tell No Tales,230000000,172558876,788241137,558241137,0.7082111181416303,-0.3328784084105879,75.02559826086956
24,2010-09-24,Wall Street 2: Money Never Sleeps,70000000,52474616,137431619,67431619,0.49065578569659435,-0.33397831820246193,74.96373714285714
17,2001-03-30,The Tailor of Panama,18000000,13491653,27491653,9491653,0.3452558127370515,-0.3341582384308283,74.95362777777778
6,2018-10-12,First Man,60000000,44936545,105203825,45203825,0.4296785311750785,-0.3352161364430665,74.89424166666667
77,2013-12-25,Grudge Match,40000000,29807260,69807260,29807260,0.42699369664415987,-0.3419549465465796,74.51815
52,2005-03-04,Be Cool,75000000,55849401,94944017,19944017,0.21006080878166342,-0.34289712435769903,74.465868
8,2006-12-08,The Holiday,85000000,63280000,205190324,120190324,0.5857504469850148,-0.34323640960809104,74.44705882352942
93,2013-04-19,Oblivion,120000000,89107235,287916633,167916633,0.5832126864306586,-0.34669199420226654,74.25602916666666
100,2012-10-19,Alex Cross,35000000,25888412,35426759,426759,0.012046233187743761,-0.3519562343182734,73.96689142857143
35,2015-08-07,The Diary of a Teenage Girl,2000000,1477002,2279959,279959,0.12279124317586412,-0.3540943072521229,73.8501
83,2006-11-21,The History Boys,3700000,2730296,13447998,9747998,0.7248661101823484,-0.3551644217330282,73.79178378378379
43,2013-10-18,All is Lost,8500000,6263670,10386814,1886814,0.181654740327496,-0.35703189982869465,73.69023529411764
9,2006-06-16,The Fast and the Furious: Tokyo Drift,85000000,62615510,157794205,72794205,0.46132369056265404,-0.35749113917622005,73.66530588235294
26,2008-11-14,Quantum of Solace,230000000,169368427,591692078,361692078,0.611284300480359,-0.3579862792254663,73.63844652173913
14,2003-04-04,A Man Apart,36000000,26500000,43797731,7797731,0.1780396112300886,-0.3584905660377358,73.61111111111111
93,2007-11-28,The Savages,9000000,6623082,10642023,1642023,0.15429613335735132,-0.35888397576838094,73.58980000000001
54,2018-03-23,Sherlock Gnomes,59000000,43242871,87527651,28527651,0.3259273003910501,-0.3643867448116477,73.29300169491525
34,2013-02-14,A Good Day to Die Hard,92000000,67349198,304249198,212249198,0.6976162941274212,-0.3660147816459522,73.20565
65,2003-07-25,Lara Croft: Tomb Raider: The Cradle of Life,90000000,65653758,157092943,67092943,0.4270907509830025,-0.37082785116428524,72.94861999999999
34,2015-09-04,The Transporter Refueled,22000000,16029670,69698495,47698495,0.6843547339149861,-0.37245495384496374,72.86213636363637
47,2017-08-25,Ballerina,30000000,21858070,96892829,66892829,0.6903795635897885,-0.3724908008804071,72.86023333333334
69,2014-04-25,Brick Mansions,28000000,20396829,73421224,45421224,0.6186388829475248,-0.37276240341084393,72.84581785714286
84,2014-07-25,Hercules,100000000,72688614,243388614,143388614,0.5891344366667868,-0.37573128028001745,72.688614
71,2009-11-06,Disneyâs A Christmas Carol,190000000,137855863,315709697,125709697,0.3981812981816646,-0.3782511375667787,72.55571736842106
56,2016-05-20,The Nice Guys,50000000,36261763,59596747,9596747,0.16102803396299467,-0.37886290856845545,72.523526
25,2008-11-07,The Boy in the Striped Pyjamas,12500000,9046156,44083403,31583403,0.716446572874603,-0.3818023920878658,72.369248
66,2016-06-10,Now You See Me 2,90000000,65075540,328325007,238325007,0.7258813733917014,-0.3830081164136325,72.30615555555555
8,2010-01-29,Edge of Darkness,60000000,43313890,82812456,22812456,0.2754713131560788,-0.38523692977010376,72.18981666666666
1,2004-03-26,Jersey Girl,35000000,25266129,37066129,2066129,0.05574169884316757,-0.3852537521675758,72.18894
9,2002-12-13,Star Trek: Nemesis,60000000,43254409,67312826,7312826,0.10863941442601148,-0.3871418287092999,72.09068166666667
10,2002-02-19,Reign of Fire,60000000,43061982,82150183,22150183,0.26963035493177173,-0.3933404180049121,71.76997
24,2010-11-24,Burlesque,55000000,39440655,90552675,35552675,0.39261871612296384,-0.39450016740340643,71.71028181818183
22,2012-04-13,Lockout,20000000,14326865,33943049,13943049,0.41077774126891187,-0.39597881322955164,71.634325
72,2011-08-05,The Change-Up,52000000,37243418,75997067,23997067,0.3157630675404881,-0.3962198636011335,71.62195769230769
1,2015-01-23,Mommy,4900000,3498695,17536004,12636004,0.7205748812557295,-0.40052219470402534,71.4019387755102
2,2012-11-21,Rise of the Guardians,145000000,103412758,306900902,161900902,0.5275347871085762,-0.40214807925343216,71.31914344827585
94,2017-03-24,Power Rangers,120000000,85364450,142531552,22531552,0.15808115244545995,-0.40573740005353515,71.13704166666666
95,2004-09-10,Cellular,45000000,32003620,61475984,16475984,0.26800683662094776,-0.4060909359628692,71.11915555555555
23,2008-08-29,Disaster Movie,20000000,14190901,36720752,16720752,0.45534884470775544,-0.4093537823990175,70.954505
81,2017-08-11,The Nut Job 2: Nutty by Nature,40000000,28370522,57438389,17438389,0.303601638270182,-0.4099141355241895,70.926305
31,2010-07-30,Charlie St. Cloud,44000000,31206263,48478084,4478084,0.09237337020167712,-0.40997337617772434,70.923325
71,2013-09-20,Rush,38000000,26947624,98230839,60230839,0.6131561087450348,-0.41014287567616353,70.9148
83,2002-03-08,The Time Machine,80000000,56684819,98983590,18983590,0.1917852241972634,-0.4113126126414905,70.85602374999999
48,2012-06-22,Seeking a Friend for the End of the World,10000000,7078738,11766959,1766959,0.15016275657967365,-0.4126811869573362,70.78738
21,2004-05-07,Van Helsing,170000000,120150546,300150546,130150546,0.4336175553716968,-0.4148916143918314,70.67679176470588
49,2010-11-19,The Next Three Days,30000000,21148651,67255916,37255916,0.553942585511734,-0.4185301937225216,70.49550333333333
88,2016-07-01,The Legend of Tarzan,180000000,126643061,348902025,168902025,0.48409585756918444,-0.42131750905799725,70.35725611111111
11,2009-11-20,Planet 51,60000000,42194060,108996113,48996113,0.4495216540428373,-0.4220011063168607,70.32343333333333
79,2018-08-17,Alpha,51000000,35851379,99624873,48624873,0.4880796485431907,-0.4225394231000152,70.29682156862745
49,2006-12-01,Turistas,10000000,7027762,14321070,4321070,0.3017281529941548,-0.42292809574370904,70.27762
32,2010-06-11,The A-Team,110000000,77222099,177241171,67241171,0.3793767024931245,-0.4244627046462438,70.20190818181818
83,2005-06-03,Cinderella Man,88000000,61649911,105021488,17021488,0.16207624100698326,-0.4274148749379379,70.05671704545455
24,2011-09-30,What's Your Number?,20000000,14011084,30163785,10163785,0.33695323713519376,-0.4274413028999041,70.05542
30,2003-11-14,Master and Commander: The Far Side of the World,135000000,93926386,212912137,77912137,0.3659356300575763,-0.4372957988610357,69.57510074074074
51,2012-12-19,Amour,9700000,6738954,36787044,27087044,0.7363202109960235,-0.4393925229345682,69.47375257731959
67,2001-11-21,Spy Game,90000000,62362560,143049560,53049560,0.3708474181954841,-0.44317359646557164,69.29173333333334
25,2011-01-14,The Dilemma,70000000,48475290,70546865,546865,0.007751797333588104,-0.44403468241242083,69.25041428571429
50,2016-11-11,Shut In,10000000,6900335,11360665,1360665,0.11976983741708781,-0.44920500236582717,69.00335
3,2016-09-16,Bridget Jonesâs Baby,35000000,24139805,205822688,170822688,0.829950719524176,-0.44988743695319827,68.97087142857143
41,2019-01-11,A Dogâs Way Home,61000000,41952715,81149689,20149689,0.24830272608931378,-0.45401793423858267,68.77494262295082
86,2016-02-26,Eddie the Eagle,23000000,15789389,45060480,22060480,0.4895749002229892,-0.4566744792974573,68.64951739130434
37,2014-04-25,Locke,2000000,1370646,2088390,88390,0.0423244700463036,-0.45916596991491604,68.5323
42,2011-01-28,The Mechanic,42500000,29121498,76347393,33847393,0.4433339721239728,-0.4594029469225793,68.52117176470588
26,2009-04-17,Crank 2: High Voltage,20000000,13684249,35472739,15472739,0.4361867573857208,-0.46153435237841695,68.421245
27,2015-10-30,Burnt,20000000,13651946,36773510,16773510,0.4561302415787887,-0.46499260984477964,68.25972999999999
36,2009-04-22,Earth,47000000,32011576,116773317,69773317,0.5975107909283762,-0.468218871823118,68.10973617021277
94,2003-04-16,Chasing Papi,9000000,6126237,12657377,3657377,0.28895220550039713,-0.46909105867108963,68.0693
52,2018-03-02,Red Sparrow,69000000,46874505,145951861,76951861,0.5272413826912423,-0.47201554448414973,67.9340652173913
58,2013-10-25,The Counselor,25000000,16973715,71009334,46009334,0.6479336082774697,-0.4728655453446697,67.89486
85,2010-12-10,The Tourist,100000000,67631157,278731369,178731369,0.6412316261396469,-0.4786084466956554,67.631157
12,2009-03-20,Duplicity,60000000,40572825,81079566,21079566,0.2599861721016119,-0.47882233982967665,67.621375
48,2010-12-10,The Chronicles of Narnia: The Voyage of the Dawn Treader,155000000,104386950,418186950,263186950,0.629352374577925,-0.48485993699403995,67.3464193548387
59,2010-06-04,Marmaduke,50000000,33644788,89895930,39895930,0.44380129333997664,-0.48611428313948657,67.289576
87,2013-04-26,The Big Wedding,32500000,21819348,48425971,15925971,0.32887251760011166,-0.4895037193595336,67.13645538461539
84,2017-01-27,Resident Evil: The Final Chapter,40000000,26844692,314101190,274101190,0.8726525041181793,-0.4900524841186481,67.11173000000001
10,2005-12-09,Memoirs of a Geisha,85000000,57010853,161510853,76510853,0.47371957722246694,-0.4909441891704374,67.07159176470589
85,2008-02-29,The Other Boleyn Girl,40000000,26814957,78269970,38269970,0.4889483156822469,-0.4917047974382357,67.03739250000001
22,2019-03-29,Dumbo,170000000,113883318,345004422,175004422,0.507252692546648,-0.4927559451683696,66.99018705882352
3,2015-09-18,Everest,65000000,43482270,221297061,156297061,0.7062771656059182,-0.49486215876034073,66.89580000000001
31,2008-09-19,Ghost Town,20000000,13367624,29958228,9958228,0.3324037723459478,-0.49615219578288555,66.83812
18,2012-08-24,Samsara,4000000,2672413,5966671,1966671,0.32960942542332233,-0.49677463775247316,66.810325
52,2005-01-19,Assault On Precinct 13,30000000,20040895,36040895,6040895,0.16761223604463762,-0.49693913370635395,66.80298333333333
13,2008-09-12,Righteous Kill,60000000,40081410,78481410,18481410,0.2354877416193211,-0.49695332574378,66.80235
10,2015-11-06,Spectre,300000000,200074175,879620923,579620923,0.6589439926271513,-0.499443893745907,66.69139166666666
85,2007-06-08,La MÃ´me,15500000,10299782,88611837,73111837,0.8250798028258912,-0.5048862199219362,66.4502064516129
55,2008-02-01,Sukkar banat,1600000,1060591,14253760,12653760,0.887748916777047,-0.508592850589907,66.2869375
57,2011-02-25,Hall Pass,68000000,45060734,87173475,19173475,0.21994620496659104,-0.50907439723463,66.26578529411765
70,2014-03-14,Need for Speed,66000000,43568507,194169619,128169619,0.6600910052771954,-0.5148556731585959,66.01288939393939
9,2012-09-14,Arbitrage,12000000,7919574,35830713,23830713,0.665091788712103,-0.5152330163213324,65.99645
25,2004-11-26,Les Choristes,5500000,3629758,83529758,78029758,0.9341552025087874,-0.515252531986981,65.9956
60,2018-12-07,Mary Queen of Scots,25000000,16468499,46734733,21734733,0.4650659499862768,-0.5180497020402406,65.873996
73,2015-11-25,The Good Dinosaur,187500000,123087120,333771037,146271037,0.43823765631288136,-0.5233112936593203,65.64646400000001
61,2010-10-15,Hereafter,50000000,32746941,108660270,58660270,0.5398502138822221,-0.526860172985318,65.493882
83,2007-09-28,The Kingdom,72500000,47467250,86509602,14009602,0.1619427401827603,-0.5273688701157113,65.47206896551724
50,2005-09-30,Serenity,39000000,25514517,40319440,1319440,0.032724660858384935,-0.528541574978668,65.42183846153846
2,2010-06-23,Knight and Day,117000000,76423035,258751370,141751370,0.5478284810627283,-0.5309520225152011,65.31883333333333
4,2012-09-14,Resident Evil: Retribution,65000000,42345531,240647629,175647629,0.7298955311959463,-0.5349907880479761,65.14697076923078
26,2008-10-24,Changeling,55000000,35739802,113805580,58805580,0.5167196546953146,-0.538900523287734,64.98145818181818
32,2002-11-22,The Quiet American,20000000,12987647,26348203,6348203,0.2409349510477053,-0.5399248224100948,64.938235
70,2018-03-16,Tomb Raider,90000000,58250803,273477501,183477501,0.6709052859160066,-0.5450430786336112,64.72311444444443
33,2013-07-31,The Smurfs 2,110000000,71017784,348547523,238547523,0.6844045854831681,-0.5489078059658972,64.56162181818182
11,2015-03-06,Chappie,49000000,31569268,105002056,56002056,0.5333424709321882,-0.5521424190133265,64.4270775510204
53,2013-10-04,Runner Runner,30000000,19316646,60512680,30512680,0.5042361369550977,-0.5530646469371546,64.38882
71,2012-06-15,That's My Boy,57500000,36931089,58085235,585235,0.010075452049044822,-0.5569538174192481,64.22798086956522
8,2015-08-21,Hitman: Agent 47,35000000,22467450,82182803,47182803,0.5741201477394242,-0.5578091861782267,64.19271428571427
37,2013-12-25,The Secret Life of Walter Mitty,91000000,58236838,187861183,96861183,0.5155997713481875,-0.5625848367660345,63.99652527472528
62,2002-04-19,Murder by Numbers,50000000,31874869,56643267,6643267,0.11728255363519198,-0.5686338977581367,63.749738
88,2006-12-25,Notes on a Scandal,27500000,17510118,50578411,23078411,0.45628975967631724,-0.5705205413235936,63.673156363636366
6,2004-02-27,"Good Bye, Lenin!",6400000,4063859,79384539,72984539,0.9193797673877026,-0.5748577891112856,63.497796875
28,2013-07-19,RED 2,84000000,53262560,141507355,57507355,0.40639127909641176,-0.577092802148451,63.40780952380952
63,2006-10-20,Flags of Our Fathers,53000000,33602376,63657941,10657941,0.1674251606724132,-0.5772694169007573,63.40070943396226
55,2017-04-28,Baahubali 2: The Conclusion,30000000,18985794,263502914,233502914,0.8861492666453017,-0.5801288057797319,63.285979999999995
87,2001-02-16,Sweet November,40000000,25288103,65754228,25754228,0.39167409888836346,-0.5817714757014395,63.2202575
33,2016-02-26,Triple 9,20000000,12639297,25943792,5943792,0.22910266933993303,-0.5823664876298105,63.196485
53,2005-12-23,Munich,75000000,47379090,131492772,56492772,0.4296264436496935,-0.5829767941933879,63.17212
37,2014-11-26,Penguins of Madagascar,132000000,83350911,366942531,234942531,0.6402706449964504,-0.5836659541729544,63.14462954545454
30,2008-05-16,The Chronicles of Narnia: Prince Caspian,225000000,141621490,417341288,192341288,0.46087289594984904,-0.5887419345750422,62.942884444444445
86,2015-07-17,Bajrangi Bhaijaan,13000000,8178001,121778347,108778347,0.8932486741670094,-0.5896305221777303,62.9077
88,2007-04-05,The Reaping,40000000,25126214,62226214,22226214,0.3571840960788648,-0.5919628798831372,62.815535
54,2010-06-04,Killers,75000000,47059963,95572749,20572749,0.21525747888658095,-0.5937114102703396,62.74661733333333
34,2016-09-02,The Light Between Oceans,20000000,12545979,22281732,2281732,0.10240370901148978,-0.5941362567241664,62.729895
61,2009-05-21,Terminator Salvation,200000000,125322469,365491792,165491792,0.45279208896707585,-0.5958830175935969,62.6612345
96,2006-07-28,The Ant Bully,45000000,28142535,49610898,4610898,0.09294123238809344,-0.599003074882913,62.53896666666666
33,2016-06-24,Independence Day: Resurgence,165000000,103144286,384169424,219169424,0.5705019980975894,-0.5997008307372451,62.511688484848484
14,2009-12-11,Invictus,60000000,37491364,124514011,64514011,0.5181265183080481,-0.6003685542089107,62.48560666666667
27,2012-07-27,The Watch,55000000,34353000,67130045,12130045,0.1806947246944345,-0.601024655779699,62.46000000000001
97,2003-07-18,Johnny English,45000000,28013509,163126676,118126676,0.7241407653031561,-0.606367842029358,62.25224222222222
89,2011-01-07,Season of the Witch,40000000,24827228,91126600,51126600,0.5610502312167907,-0.6111343561995725,62.06807
70,2006-05-12,Just My Luck,28000000,17326650,38159905,10159905,0.26624555276015494,-0.6160077106653623,61.880892857142854
56,2006-03-03,Ultraviolet,30000000,18522064,30962112,962112,0.03107384922578925,-0.6196899006503811,61.74021333333334
15,2009-04-17,State of Play,60000000,37017955,88832210,28832210,0.32456932006982603,-0.6208350785449925,61.69659166666667
58,2011-12-25,The Darkest Hour,34800000,21443494,62831715,28031715,0.4461395809425224,-0.6228698550711932,61.61923563218391
88,2016-09-09,Robinson Crusoe,13000000,8005586,42446455,29446455,0.6937317851396542,-0.6238661354709074,61.58143076923077
34,2011-07-29,Cowboys and Aliens,163000000,100368560,176038324,13038324,0.07406525865356454,-0.6240145320407108,61.5758036809816
97,2011-12-02,Shame,6500000,4002293,20412841,13912841,0.6815729863373747,-0.6240690024443488,61.57373846153846
45,2012-04-27,The Raven,26000000,16008272,30601801,4601801,0.15037680298620332,-0.6241603091201848,61.570276923076925
30,2003-12-12,Stuck On You,55000000,33832741,63537164,8537164,0.13436488918517042,-0.6256442243328733,61.51407454545455
31,2013-07-17,Turbo,135000000,83028130,286896578,151896578,0.5294471584809213,-0.6259549624928322,61.502318518518514
26,2005-12-25,Rumor Has It,70000000,42996140,88933562,18933562,0.21289557703760928,-0.6280531229082424,61.42305714285714
4,2007-06-22,A Mighty Heart,15000000,9176787,19153568,4153568,0.2168560969945652,-0.6345590237628922,61.178580000000004
52,2016-07-22,Ice Age: Collision Course,105000000,64063008,402156682,297156682,0.7389077324842261,-0.6390113932833126,61.012388571428566
58,2011-08-19,Fright Night,30000000,18298649,40520649,10520649,0.25963673484104366,-0.6394652960445332,60.99549666666667
18,2012-09-14,Barfi,4600000,2804874,36751984,32151984,0.8748366890886763,-0.6400023673077649,60.975521739130436
80,2007-12-25,Persepolis,7300000,4443403,25397187,18097187,0.7125665925127849,-0.6428849690203657,60.868534246575344
32,2016-06-03,Teenage Mutant Ninja Turtles: Out of the Shadows,135000000,82051601,245328374,110328374,0.4497171370809313,-0.6453061043866773,60.7789637037037
38,2010-10-01,Let Me In,20000000,12134935,28270399,8270399,0.2925462424495671,-0.6481340855966679,60.674675
55,2015-08-14,The Man From U.N.C.L.E.,75000000,45445109,104949584,29949584,0.28537115497284865,-0.6503426144274403,60.59347866666667
17,2006-04-21,The Sentinel,60000000,36280697,78080697,18080697,0.23156423667683193,-0.6537719768724399,60.46782833333333
11,2001-03-16,Enemy at the Gates,85000000,51396781,96971293,11971293,0.12345192715951514,-0.6538000696969719,60.46680117647058
66,2009-11-06,The Box,25000000,15051977,34356760,9356760,0.27234116371858114,-0.6609113872549766,60.207907999999996
34,2016-03-18,The Divergent Series: Allegiant,110000000,66184051,172022517,62022517,0.3605488286164305,-0.6620318390604407,60.16731909090909
29,2017-05-12,The Wall,3000000,1803064,4495262,1495262,0.33263066757844145,-0.6638344506906022,60.10213333333333
57,2008-03-28,"Run, Fatboy, Run",10000000,6003262,33512260,23512260,0.7016017421683886,-0.6657610479102861,60.03262
49,2016-03-04,The Other Side of the Door,5000000,3000342,12905107,7905107,0.6125564863584626,-0.6664766883241977,60.00684
33,2017-06-21,Transformers: The Last Knight,217000000,130168683,602893340,385893340,0.6400690045771611,-0.6670676463708248,59.98556820276497
9,2008-07-25,The X-Files: I Want to Believe,35000000,20982478,68170792,33170792,0.4865836383417696,-0.6680584628755478,59.949937142857145
61,2014-07-18,Wish I Was Here,6000000,3591299,6591365,591365,0.08971813880736387,-0.6707046670299521,59.85498333333334
52,2011-12-21,The Adventures of Tintin,130000000,77591831,373993951,243993951,0.6524007951133948,-0.6754341059434465,59.686023846153844
35,2009-06-12,The Taking of Pelham 123,110000000,65452312,152364370,42364370,0.2780464356594655,-0.6806129018024604,59.50210181818182
59,2017-09-15,mother!,30000000,17800004,42531076,12531076,0.2946334111086209,-0.6853928796869934,59.333346666666664
60,2015-10-09,Steve Jobs,30000000,17766658,35579007,5579007,0.15680614695064424,-0.6885561707778695,59.22219333333333
19,2003-10-10,Intolerable Cruelty,60000000,35327628,121327628,61327628,0.5054712517745752,-0.6983874490526225,58.879380000000005
46,2005-06-17,My Summer of Love,1700000,1000915,4727375,3027375,0.6403923953568312,-0.698445921981387,58.877352941176476
88,2007-06-08,Surf's Up,100000000,58867694,145395745,45395745,0.31222196357947063,-0.6987246009670431,58.867694
2,2011-05-20,Pirates of the Caribbean: On Stranger Tides,410600000,241063875,1045663875,635063875,0.6073307973845802,-0.7032829991636034,58.71014978080857
8,2008-08-01,The Mummy: Tomb of the Dragon Emperor,175000000,102491776,405760225,230760225,0.5687108069796639,-0.7074540692903984,58.56672914285714
64,2008-10-10,Body of Lies,67500000,39394666,118556530,51056530,0.43065135256573384,-0.7134299349054006,58.36246814814815
69,2004-04-09,The Girl Next Door,25000000,14589444,31635150,6635150,0.20973979892619446,-0.7135677000439495,58.357775999999994
62,2011-06-17,Green Lantern,200000000,116601172,219535492,19535492,0.08898557505225624,-0.7152486254597853,58.300585999999996
56,2003-03-07,Tears of the Sun,75000000,43632458,85632458,10632458,0.12416387720646767,-0.7189038490565899,58.17661066666666
70,2008-08-15,Fly Me To the Moon,25000000,14543943,43530281,18530281,0.4256871440825296,-0.718928628914456,58.175772
60,2001-03-09,15 Minutes,42000000,24375436,56331864,14331864,0.25441842293732725,-0.7230461026420204,58.036752380952386
84,2018-09-14,The Predator,88000000,51024708,159487563,71487563,0.44823283806775577,-0.724654651624856,57.98262272727273
49,2015-07-01,Terminator: Genisys,155000000,89760956,432150894,277150894,0.6413289845004926,-0.7268087028841359,57.91029419354838
64,2016-02-12,Zoolander 2,50000000,28848693,55348693,5348693,0.09663630178222998,-0.7331807718290738,57.697385999999995
72,2004-07-07,King Arthur,90000000,51877963,203877963,113877963,0.5585594505866237,-0.7348406682814436,57.642181111111114
61,2002-07-17,Eight Legged Freaks,30000000,17266505,36722311,6722311,0.18305795079182244,-0.7374680052506283,57.55501666666667
28,2017-09-15,American Assassin,63000000,36249674,68310140,5310140,0.07773575050497628,-0.7379466640168957,57.539165079365084
61,2005-09-16,Lord of War,42000000,24149632,60437727,18437727,0.30506982832097573,-0.7391569362216368,57.49912380952381
89,2006-12-08,Blood Diamond,100000000,57377916,171377916,71377916,0.41649424655158007,-0.7428308131651209,57.377916
65,2009-01-16,Defiance,50000000,28644813,52987754,2987754,0.05638574527993769,-0.745516718855871,57.289626000000005
38,2005-05-13,Danny the Dog,43000000,24537621,49037621,6037621,0.12312222487302148,-0.7524111241264995,57.064234883720935
86,2005-10-28,The Legend of Zorro,80000000,45575336,141475336,61475336,0.43453041171784174,-0.7553353857884888,56.969170000000005
39,2002-04-12,The Sweetest Thing,43000000,24430272,63078756,20078756,0.318312491768227,-0.760111389672616,56.81458604651163
39,2007-09-07,In the Shadow of the Moon,2000000,1134358,2175587,175587,0.08070787332338353,-0.7631118218410766,56.7179
33,2015-10-16,Crimson Peak,55000000,31090320,74966854,19966854,0.26634242914875417,-0.7690393665938465,56.527854545454545
34,2012-04-27,The Pirates! Band of Misfits,55000000,31051126,136143605,81143605,0.5960148109784518,-0.7712723203660956,56.45659272727273
64,2008-04-18,88 Minutes,30000000,16930884,32955399,2955399,0.08967875036196649,-0.7719098423921633,56.436280000000004
95,2014-06-06,Edge of Tomorrow,178000000,100206256,370541256,192541256,0.5196216423468916,-0.776336200007313,56.29564943820225
36,2013-11-01,Ender's Game,110000000,61737191,127983283,17983283,0.14051274962215182,-0.7817461115132368,56.12471909090909
99,2009-07-31,Aliens in the Attic,45000000,25200412,59551283,14551283,0.2443487741481573,-0.7856850911802553,56.00091555555555
40,2008-02-22,Be Kind Rewind,20000000,11175164,30894247,10894247,0.35263028097108173,-0.789682907561804,55.87582
7,2008-08-22,Death Race,65000000,36316032,72516819,7516819,0.10365621525676685,-0.789843119424501,55.87081846153846
62,2006-12-21,Venus,6000000,3347411,7818479,1818479,0.2325873101405017,-0.7924300302532316,55.79018333333333
87,2012-03-30,Wrath of the Titans,150000000,83670083,305270083,155270083,0.5086318366808319,-0.7927554822671803,55.78005533333334
90,2010-09-24,Legend of the Guardians: The Owls of Ga'Hoole,100000000,55675313,139716717,39716717,0.28426603382041965,-0.7961282049730012,55.675313
12,2005-08-19,Valiant,35000000,19478106,64188387,29188387,0.4547300277229275,-0.7968892868741961,55.65173142857142
11,2010-09-03,Going the Distance,32000000,17804299,43603990,11603990,0.2661222057889656,-0.7973187262244922,55.638434375
65,2012-06-22,Abraham Lincoln: Vampire Hunter,67500000,37519139,137489730,69989730,0.5090542399057734,-0.7990817966265163,55.58390962962962
66,2007-02-09,Hannibal Rising,50000000,27669725,80583311,30583311,0.3795241300025511,-0.8070291627401429,55.33945
27,2002-12-31,Confessions of a Dangerous Mind,29000000,16007718,33013805,4013805,0.12157959374873634,-0.8116261168518836,55.199027586206896
28,2007-08-10,Stardust,70000000,38634938,137022245,67022245,0.48913404535154126,-0.8118315603353627,55.19276857142857
41,2005-12-09,Mrs. Henderson Presents,20000000,11036366,27836366,7836366,0.2815154104526431,-0.812190715675794,55.18183
23,2015-05-22,Tomorrowland,170000000,93436322,206627518,36627518,0.17726350466059415,-0.819420931401816,54.96254235294118
88,2007-11-16,Beowulf,150000000,82280579,195080579,45080579,0.23108696535086662,-0.8230304383249418,54.85371933333333
78,2018-07-13,Skyscraper,125000000,68420120,304115534,179115534,0.5889719990429689,-0.8269479796293838,54.736096
14,2011-11-23,Arthur Christmas,85000000,46462469,149717124,64717124,0.4322626715698867,-0.8294335585136468,54.66172823529411
95,2002-07-19,Stuart Little 2,120000000,64956806,166000000,46000000,0.27710843373493976,-0.8473814737750498,54.130671666666665
72,2013-07-12,Pacific Rim,190000000,101802906,411002906,221002906,0.5377161639825486,-0.8663514379442174,53.58047684210526
23,2019-02-08,Cold Pursuit,60000000,32138862,62599159,2599159,0.0415206696307214,-0.8668987097302947,53.564769999999996
68,2013-03-29,The Host,50000000,26623701,64477051,14477051,0.2245302906300724,-0.8780258988034759,53.247402
89,2012-05-11,Dark Shadows,150000000,79727149,238202668,88202668,0.3702841313263544,-0.8814168307962448,53.151432666666665
68,2011-07-22,Elle s'appelait Sarah,14500000,7691700,25480031,10980031,0.4309269089978736,-0.8851489267652145,53.04620689655173
94,2016-08-26,Mechanic: Resurrection,40000000,21218403,109738840,69738840,0.63549824291928,-0.8851560129195397,53.0460075
95,2004-01-16,Torque,40000000,21176322,46176322,6176322,0.13375517435104511,-0.8889021426855901,52.940805000000005
70,2015-03-13,Run All Night,50000000,26461644,66961644,16961644,0.2533038764699385,-0.8895273475827882,52.923288
45,2002-09-20,Sen to Chihiro no Kamikakushi,19000000,10049886,274949886,255949886,0.9308964979894554,-0.890568708938589,52.89413684210527
15,2017-01-20,xXx: Return of Xander Cage,85000000,44898413,345033359,260033359,0.7536470089548647,-0.8931626826097394,52.82166235294118
2,2010-09-24,Buried,1987650,1044143,21270290,19282640,0.9065527550400111,-0.9036185656562368,52.53153221140543
96,2009-11-13,Fantastic Mr. Fox,40000000,21002919,47083412,7083412,0.1504438973114353,-0.9044971796539328,52.50729750000001
67,2008-10-24,Pride and Glory,30000000,15740721,43440721,13440721,0.30940372743813344,-0.9058847431448661,52.469069999999995
45,2009-09-17,Bright Star,8500000,4444637,17220091,8720091,0.5063905295273992,-0.9124171445272133,52.289847058823526
66,2017-03-24,Life,58000000,30234022,100929666,42929666,0.4253423963574793,-0.9183686510514546,52.127624137931036
12,2008-02-08,In Bruges,15000000,7800825,34533783,19533783,0.5656427215054893,-0.9228735422214958,52.005500000000005
78,2012-04-27,Safe,33000000,17142080,41495213,8495213,0.20472754290958817,-0.9250872706229349,51.945696969696975
26,2013-08-21,The Mortal Instruments: City of Bones,60000000,31165421,75965567,15965567,0.21016847014384823,-0.9252106364935677,51.942368333333334
72,2015-08-21,American Ultra,28000000,14439985,30295028,2295028,0.07575592932279185,-0.9390601860043484,51.571374999999996
6,2008-09-19,The Duchess,27000000,13848978,45160110,18160110,0.4021272313109956,-0.9496023461081388,51.29251111111112
17,2010-07-30,Cats & Dogs: The Revenge of Kitty Galore,85000000,43585753,113026383,28026383,0.2479631945755532,-0.9501785365506935,51.27735647058823
100,2009-06-05,My Life in Ruins,17000000,8677425,20477425,3477425,0.16981749414294034,-0.9591065321797653,51.04367647058824
1,2008-12-26,Revolutionary Road,45000000,22951340,79604820,34604820,0.4347075968515474,-0.96066983452818,51.00297777777778
67,2009-12-18,Did You Hear About the Morgans?,58000000,29580087,80480566,22480566,0.2793291240024331,-0.9607785467297645,51.00015
100,2016-07-06,Sultan,11000000,5599781,72989781,61989781,0.8492939717136568,-0.9643625348919895,50.90710000000001
72,2009-02-13,The International,50000000,25450527,53850527,3850527,0.07150397989605561,-0.9645958608244144,50.901054
24,2019-02-14,Alita: Battle Angel,170000000,85710210,402976036,232976036,0.5781386861426172,-0.9834276453178682,50.417770588235285
17,2010-04-30,Furry Vengeance,35000000,17630465,39340177,4340177,0.11032428755976366,-0.9852000500270413,50.37275714285714
25,2019-05-31,Godzilla: King of the Monsters,170000000,85576941,299276941,129276941,0.4319642554753324,-0.9865164378801528,50.33937705882353
18,2013-01-25,Parker,35000000,17616641,48543388,13543388,0.27899552458102017,-0.9867578615015201,50.33326
39,2010-05-14,Robin Hood,210000000,105487148,322459006,112459006,0.3487544274077431,-0.990763841676713,50.23197523809524
2,2008-08-29,Babylon A.D.,45000000,22532572,70216497,25216497,0.3591249646076762,-0.9971088964011743,50.072382222222224
62,2010-06-18,Io sono lâamore,10000000,5005465,15121528,5121528,0.33869116930511256,-0.9978163866893486,50.05465
77,2012-12-21,Cirque du Soleil: Worlds Away,25000000,12512862,28012862,3012862,0.10755280913460394,-0.9979441953407622,50.051448
80,2017-10-06,Blade Runner 2049,185000000,92054159,259357408,74357408,0.2866986085857243,-1.0096864933609355,49.75900486486486
59,2003-03-21,Dreamcatcher,68000000,33685268,75685268,7685268,0.1015424560563094,-1.0186866258567395,49.53715882352941
7,2010-10-01,Case 39,27000000,13261851,28773827,1773827,0.06164723934706357,-1.0359148960427922,49.11796666666667
51,2014-10-10,Kill the Messenger,5000000,2450846,6656705,1656705,0.2488776354067065,-1.0401118634136948,49.016920000000006
78,2015-11-13,The 33,25000000,12227722,28400715,3400715,0.11974047132264103,-1.044534542083963,48.910888
96,2014-02-12,RoboCop,120000000,58607007,242981799,122981799,0.5061358484715145,-1.0475367390796804,48.8391725
90,2013-06-28,White House Down,150000000,73103784,205440387,55440387,0.269861188491628,-1.0518773693027983,48.735856
29,2011-05-13,Priest,60000000,29136626,84154026,24154026,0.2870216334034928,-1.059263828282657,48.56104333333333
62,2011-03-25,Sucker Punch,75000000,36392502,89758389,14758389,0.16442350586305643,-1.0608640757923158,48.523336
88,2009-09-25,Surrogates,80000000,38577772,119668350,39668350,0.331485727011361,-1.073733029476145,48.222215
19,2004-09-17,Wimbledon,35000000,16862585,41666476,6666476,0.1599961561424105,-1.0756011014918532,48.17881428571428
14,2001-10-08,Mulholland Drive,15000000,7219578,20785973,5785973,0.2783594975323022,-1.0776837648959539,48.13052
89,2001-06-08,Evolution,80000000,38311134,98341932,18341932,0.18651181268230524,-1.0881658057942112,47.8889175
52,2010-02-12,My Name is Khan,8470000,4046336,42355526,33885526,0.8000260934075049,-1.0932517714791852,47.77256198347107
100,2012-12-21,The Impossible,40000000,19019882,169590606,129590606,0.7641378791936152,-1.1030624690521214,47.549704999999996
33,2011-11-18,Happy Feet Two,135000000,64006466,157956466,22956466,0.14533413276035184,-1.109161908735908,47.41219703703703
3,2016-11-18,Nocturnal Animals,22500000,10663357,32398681,9898681,0.3055272836570106,-1.1100297026536765,47.39269777777778
30,2006-06-16,Garfield: A Tail of Two Kitties,60000000,28426747,147985373,87985373,0.5945545239798801,-1.1106882190916885,47.37791166666667
90,2005-08-26,The Brothers Grimm,80000000,37899638,105299638,25299638,0.24026329511218264,-1.1108381035196166,47.374547500000006
48,2015-07-10,Self/Less,26000000,12279691,33667319,7667319,0.22773773581436646,-1.117317121416166,47.229580769230765
36,2008-10-24,LÃ¥t den rÃ¤tte komma in,4500000,2122085,12247682,7747682,0.632583537031742,-1.120555962649941,47.157444444444444
79,2012-08-03,Total Recall,125000000,58877969,211856088,86856088,0.4099768329527543,-1.1230351882552199,47.102375200000004
34,2006-07-28,Miami Vice,135000000,63478838,163818556,28818556,0.1759175315890344,-1.1266929933405523,47.021361481481485
98,2015-08-07,Fantastic Four,120000000,56117548,167849187,47849187,0.2850724978489172,-1.138368554520593,46.76462333333333
92,2006-04-14,The Wild,80000000,37384046,99010667,19010667,0.1920062512052363,-1.1399502878848373,46.7300575
21,2016-04-15,Criminal,31500000,14708696,38771262,7271262,0.1875425669662236,-1.1415902538199172,46.694273015873016
39,2013-10-11,La Vie d'AdÃ¨le â Chapitres 1 & 2,5250000,2450504,22914479,17664479,0.7708872193864849,-1.1424164171941773,46.67626666666666
53,2013-05-31,After Earth,130000000,60522097,251499665,121499665,0.48310070313612546,-1.147975804605713,46.55545923076923
16,2014-12-12,Exodus: Gods and Kings,140000000,65014513,268314513,128314513,0.4782242733176345,-1.1533653570549702,46.43893785714286
75,2010-02-05,From Paris With Love,52000000,24077427,53139168,1139168,0.021437445162859906,-1.159699207062283,46.302744230769235
63,2005-03-11,Hostage,75000000,34636443,77636443,2636443,0.03395883296714147,-1.165349369160107,46.181924
54,2013-05-31,Yeh Jawaani Hai Deewani,8300000,3827466,50827466,42527466,0.8367024631918497,-1.168536572238656,46.11404819277109
64,2016-10-28,Inferno,75000000,34343574,219519367,144519367,0.6583444958640028,-1.1838146489937245,45.791432
7,2005-12-23,CachÃ©,8000000,3647381,19891331,11891331,0.5978147465345582,-1.1933546289789851,45.592262500000004
63,2010-05-28,Prince of Persia: Sands of Time,200000000,90759676,336359676,136359676,0.4053984045340798,-1.2036217934493287,45.379838
26,2016-05-27,Alice Through the Looking Glass,170000000,77042381,276928112,106928112,0.3861222727723648,-1.2065777016938248,45.319047647058824
94,2019-03-15,Wonder Park,100000000,45216793,115149422,15149422,0.1315631614720567,-1.2115677244071688,45.216793
93,2013-12-20,Walking with Dinosaurs,80000000,36076121,123368842,43368842,0.3515380488049,-1.217533309637142,45.09515125
31,2005-04-29,XXX: State of the Union,60000000,26873932,71073932,11073932,0.15580863037097764,-1.232646863882814,44.78988666666667
76,2001-08-17,Captain Corelli's Mandolin,57000000,25528495,62097495,5097495,0.08208857700298539,-1.2327990741326507,44.786833333333334
52,2010-12-17,Rabbit Hole,5000000,2229058,6205034,1205034,0.19420264256408587,-1.243100000089724,44.58116
63,2009-08-14,Gake no ue no Ponyo,34000000,15090399,205312666,171312666,0.8343989162363709,-1.253088205288674,44.38352647058824
64,2012-01-27,Man on a Ledge,42000000,18620000,49621440,7621440,0.15359167327671264,-1.255639097744361,44.333333333333336
33,2003-07-02,Sinbad: Legend of the Seven Seas,60000000,26483452,80767884,20767884,0.2571304703240709,-1.265565682298516,44.139086666666664
30,2008-06-20,Brick Lane,2500000,1094998,3838486,1338486,0.3487015453488694,-1.283109192893503,43.79992
80,2016-12-21,Assassinâs Creed,125000000,54647948,240759682,115759682,0.4808100801528721,-1.2873685943340452,43.7183584
96,2006-11-03,Flushed Away,149000000,64665672,179357126,30357126,0.1692551987033958,-1.3041591526335643,43.39977986577181
87,2012-09-14,The Master,37500000,16247159,50647416,13147416,0.2595871031209174,-1.3080958338624002,43.32575733333333
39,2005-05-06,Kingdom of Heaven,110000000,47398413,218853353,108853353,0.4973803302890223,-1.3207528066393277,43.08946636363636
53,2007-08-17,Death at a Funeral,20000000,8580428,46790428,26790428,0.5725621488224044,-1.3308860583644546,42.90214
22,2007-11-09,Lions for Lambs,35000000,14998070,63211088,28211088,0.44629967451280067,-1.333633594189119,42.85162857142858
54,2016-12-28,Paterson,5000000,2141423,10727536,5727536,0.5339097440456038,-1.3348960013972018,42.82846
12,2007-11-30,Le Scaphandre et le Papillon,14000000,5990075,22754472,8754472,0.38473632787436246,-1.337199450758129,42.786249999999995
30,2003-10-24,Elephant,3000000,1266955,10051516,7051516,0.7015375591104864,-1.3678820479022538,42.231833333333334
37,2004-11-12,Veer-Zaara,7000000,2938532,7017859,17859,0.0025447932196984865,-1.3821418313634155,41.97902857142857
73,2003-04-18,Winged Migration,28000000,11689053,39134983,11134983,0.2845276053908085,-1.3954036310725941,41.74661785714286
10,2016-04-22,The Huntsman: Winterâs War,115000000,48003015,165149302,50149302,0.3036603933088376,-1.3956828545040347,41.74175217391304
37,2006-01-27,Rang De Basanti,5300000,2197694,29197694,23897694,0.8184788154845379,-1.411618723989782,41.46592452830188
35,2018-11-02,The Nutcracker and the Four Realms,132900000,54858851,170293899,37393899,0.2195844902229879,-1.4225808156280926,41.278292701279156
65,2017-06-09,The Mummy,195000000,80101125,409953905,214953905,0.5243367665933076,-1.4344227375083682,41.0775
89,2011-11-23,Hugo,180000000,73864507,180047784,47784,0.00026539621281870373,-1.436894353061884,41.03583722222222
39,2005-02-18,Der Untergang,13500000,5501940,93631744,80131744,0.8558181293728759,-1.4536799746998332,40.755111111111106
58,2011-09-16,I Don't Know How She Does It,24000000,9659074,24474463,474463,0.01938604332197197,-1.4847102320574415,40.24614166666667
67,2011-12-21,Albert Nobbs,7500000,3014696,8539003,1039003,0.12167731994004452,-1.48781303322126,40.195946666666664
74,2013-01-18,The Last Stand,30000000,12050299,48330757,18330757,0.37927725816502317,-1.4895647817535482,40.16766333333333
8,2010-12-29,Another Year,8000000,3205706,20005613,12005613,0.6001122285030707,-1.495550122188373,40.071325
2,2006-10-20,Marie Antoinette,40000000,15962471,60862471,20862471,0.34278054533802943,-1.5058776927456907,39.9061775
17,2016-07-01,The BFG,140000000,55483770,199646680,59646680,0.2987611915209409,-1.523260405700622,39.63126428571429
44,2010-07-14,The Sorcerer's Apprentice,160000000,63150991,217986320,57986320,0.2660089862519813,-1.533610280161716,39.469369375
96,2014-08-15,The Expendables 3,100000000,39322544,209461378,109461378,0.5225850180361173,-1.5430704585135693,39.322544
20,2003-10-22,In the Cut,12000000,4717455,23693646,11693646,0.49353510219575325,-1.5437444554320072,39.312124999999995
13,2006-10-06,Little Children,14000000,5463019,14121177,121177,0.00858122520523608,-1.562685577333705,39.021564285714284
85,2013-02-14,Beautiful Creatures,50000000,19452138,60282876,10282876,0.17057706404054113,-1.5704115403664112,38.904275999999996
67,2016-04-29,The Man Who Knew Infinity,10000000,3877922,12382122,2382122,0.19238398717118116,-1.5787006546289482,38.779219999999995
50,2018-03-23,Pacific Rim: Uprising,155000000,59874525,290930148,135930148,0.46722606417537726,-1.5887470506029067,38.62872580645161
9,2002-09-20,8 femmes,8000000,3076425,42376425,34376425,0.8112157880236474,-1.6004209431401708,38.4553125
13,2010-12-25,Gulliver's Travels,112000000,42779261,232017848,120017848,0.5172785155735088,-1.6180910418251497,38.19576875
54,2008-11-26,Australia,130000000,49554002,215080810,85080810,0.39557601628894734,-1.6234006286717266,38.11846307692308
24,2011-05-27,The Tree of Life,35000000,13305665,61721826,26721826,0.4329396541184637,-1.630458530257601,38.01618571428572
48,2017-09-22,Friend Request,9900000,3759078,11310835,1410835,0.1247330546330134,-1.633624521757729,37.97048484848485
45,2006-05-12,Poseidon,160000000,60674817,181674817,21674817,0.11930556671484085,-1.6370083654310816,37.921760625
60,2006-02-24,Doogal,20000000,7578946,28058652,8058652,0.28720738259272044,-1.6388893653550243,37.894729999999996
47,2016-11-23,Allied,106000000,40098064,119266661,13266661,0.11123528477082124,-1.6435191484556462,37.82836226415095
64,2018-08-03,The Darkest Minds,34000000,12695691,38361428,4361428,0.11369305647328874,-1.6780740016435498,37.34026764705882
40,2017-03-31,Ghost in the Shell,110000000,40563557,167910690,57910690,0.34488983399448836,-1.7117937413624746,36.87596090909091
9,2011-09-30,Take Shelter,4750000,1728953,4972016,222016,0.04465311455152196,-1.7473274287965028,36.39901052631579
98,2005-05-13,Layer Cake,6500000,2339957,11745931,5245931,0.44661687523960425,-1.7778288233501727,35.99933846153846
37,2013-10-18,Escape Plan,70000000,25135965,103735965,33735965,0.325209921168613,-1.7848542914505172,35.908521428571426
70,2006-02-17,Nochnoy dozor,4200000,1502188,33913542,29713542,0.8761556666655462,-1.7959216822395065,35.766380952380956
18,2009-06-19,Whatever Works,15000000,5306706,35106706,20106706,0.5727312041180964,-1.8266122148089605,35.37804
11,2010-02-19,The Ghost Writer,45000000,15541549,65532491,20532491,0.3133177250960901,-1.8954642809413655,34.53677555555556
87,2007-09-14,Eastern Promises,50000000,17181265,56077088,6077088,0.1083702491826965,-1.9101466044554927,34.36253
14,2007-09-14,Dragon Wars: D-War,32000000,10977721,79915361,47915361,0.5995763567907801,-1.9149948336271254,34.305378125000004
96,2015-10-23,The Last Witch Hunter,80000000,27367660,130818912,50818912,0.38846762461990203,-1.9231582093609756,34.209575
41,2007-12-07,The Golden Compass,205000000,70107728,367262558,162262558,0.4418162278333856,-1.9240713662836142,34.198891707317074
3,2004-10-10,Vera Drake,11000000,3753806,13353855,2353855,0.1762678267811055,-1.9303592140883146,34.12550909090909
13,2008-09-05,Bangkok Dangerous,45000000,15298133,46598133,1598133,0.03429607362166205,-1.941535414811729,33.99585111111111
99,2017-10-20,Geostorm,100000000,33700160,220796009,120796009,0.547093262904041,-1.967344962160417,33.700160000000004
16,2015-10-23,Suffragette,14000000,4702420,34044909,20044909,0.5887784573017951,-1.9771904678867476,33.58871428571429
62,2008-07-04,Ne le dis Ã personne,18500000,6198883,33954018,15454018,0.4551454852854233,-1.9844086426538459,33.50747567567567
66,2013-03-01,Jack the Giant Slayer,195000000,65187603,197687603,2687603,0.013595202527697197,-1.9913663185314545,33.42954
39,2001-10-26,Donnie Darko,4500000,1480006,7510877,3010877,0.40086889986349133,-2.0405282140748078,32.889022222222216
94,2009-11-25,The Road,25000000,8114270,29206732,4206732,0.14403295788108028,-2.080991882202589,32.45708
62,2011-11-11,Melancholia,9400000,3030848,21817298,12417298,0.5691492136193951,-2.1014422366281647,32.24306382978723
28,2008-06-06,Mongol,18000000,5705761,27147349,9147349,0.3369518327553825,-2.1547062696807666,31.698672222222225
29,2008-10-08,RocknRolla,18000000,5700626,27794339,9794339,0.3523861099916785,-2.1575479605222303,31.670144444444443
80,2009-04-10,Dragonball Evolution,30000000,9362785,58228460,28228460,0.4847880229015158,-2.2041748261868666,31.20928333333333
40,2011-09-02,Salvando al Soldado Perez,4500000,1400726,9330465,4830465,0.5177089244748252,-2.21261974147692,31.127244444444447
22,2007-09-28,Se jie,15000000,4604982,65167430,50167430,0.7698236680501287,-2.2573417225083614,30.69988
20,2006-08-11,Kabhi Alvida Naa Kehna,10750000,3275443,32575443,21825443,0.6699968132436449,-2.2819988013835073,30.469237209302324
92,2017-02-17,The Great Wall,150000000,45157105,334486852,184486852,0.5515518798329329,-2.3217364133506786,30.104736666666664
100,2005-07-22,The Island,120000000,35818913,163018913,43018913,0.26388909242696273,-2.350185417407837,29.849094166666667
32,2012-05-18,Battleship,220000000,65233400,313477717,93477717,0.2981957310860472,-2.372505495651001,29.651545454545452
38,2007-10-12,Elizabeth: The Golden Age,55000000,16285240,74870866,19870866,0.26540184535864725,-2.3772913386600383,29.60952727272727
46,2016-06-10,Warcraft,160000000,47225655,425522281,265522281,0.6239914872988754,-2.3879890072461674,29.516034375
94,2007-09-14,In the Valley of Elah,23000000,6777741,24489150,1489150,0.06080856215916028,-2.3934610366492315,29.46843913043478
14,2014-01-24,"I, Frankenstein",65000000,19075290,74575290,9575290,0.12839762339509508,-2.407549767264351,29.346600000000002
33,2015-09-30,The Walk,35000000,10161183,61492104,26492104,0.43082123194223443,-2.4444808247228695,29.03195142857143
97,2014-02-21,Pompeii,80000000,23169033,108469033,28469033,0.2624623103259342,-2.452884719012658,28.96129125
40,2009-01-23,Inkheart,60000000,17303424,66655938,6655938,0.09985513968762995,-2.4675218037771023,28.83904
100,2015-12-25,Point Break,100000000,28782481,126704591,26704591,0.21076261553932168,-2.474335655776165,28.782480999999997
18,2014-12-19,Mr. Turner,14000000,3958546,25187026,11187026,0.4441582741844949,-2.5366520939759196,28.27532857142857
23,2005-10-21,"Kiss Kiss, Bang Bang",15000000,4235837,16829464,1829464,0.10870601701872384,-2.541212752048769,28.238913333333333
4,2003-01-31,The Guru,11000000,3051221,24150550,13150550,0.5445238307202114,-2.605114149384787,27.738372727272726
3,2013-03-22,The Sapphires,9000000,2450867,20395040,11395040,0.5587162368889691,-2.672169889267757,27.231855555555555
31,2010-08-20,Mao's Last Dancer,18000000,4806750,25941437,7941437,0.30612941758006695,-2.7447339678577003,26.70416666666667
95,2009-09-25,Coco avant Chanel,23000000,6113834,50813834,27813834,0.5473673566926676,-2.7619601709827255,26.58188695652174
63,2012-10-26,Cloud Atlas,102000000,27108272,130673154,28673154,0.2194265089828627,-2.762689115706084,26.57673725490196
14,2012-03-09,John Carter,275000000,73058679,282778100,7778100,0.027506019737737822,-2.7640976235006933,26.566792363636367
91,2015-02-06,Jupiter Ascending,179000000,47482519,181982519,2982519,0.016389041191368497,-2.769808421495077,26.5265469273743
22,2009-02-13,Two Lovers,12000000,3149034,16349034,4349034,0.26601167995613684,-2.8106924218665155,26.241950000000003
13,2012-11-16,Anna Karenina,49000000,12816367,71004627,22004627,0.30990412779719273,-2.8232363352266674,26.15585102040816
43,2007-04-27,Next,70000000,18211013,73591500,3591500,0.048803190585869294,-2.843827907870913,26.015732857142858
85,2009-12-25,The Imaginarium of Doctor Parnassus,30000000,7689607,64352607,34352607,0.5338184201302054,-2.9013697318991727,25.632023333333333
42,2010-12-22,Somewhere,7000000,1785645,17023121,10023121,0.5887945577077199,-2.9201521019015537,25.509214285714286
11,2009-02-13,Gomorra,6200000,1579146,37339594,31139594,0.8339564163445377,-2.9261727541341966,25.470096774193546
81,2010-04-30,Harry Brown,7300000,1818681,12023606,4723606,0.39286101024933784,-3.013897984308408,24.913438356164384
71,2010-08-13,Animal Kingdom,4200000,1044039,8078683,3878683,0.4801132808404539,-3.0228382273076004,24.858071428571428
43,2012-01-13,We Need to Talk About Kevin,7000000,1738692,10765283,3765283,0.3497616365496383,-3.026014958371005,24.83845714285714
25,2015-10-30,Scouts Guide to the Zombie Apocalypse,15000000,3703046,15554855,554855,0.03567085646249997,-3.0507193267380424,24.686973333333334
33,2014-04-11,The Railway Man,18000000,4438438,23910210,5910210,0.24718352536426905,-3.0554807794994545,24.657988888888887
2,2010-04-22,Oceans,80000000,19422319,86787530,6787530,0.07820858595699175,-3.118972610840137,24.27789875
23,2013-11-15,La grande bellezza,12000000,2883879,29549145,17549145,0.5938968792498057,-3.1610622359675977,24.032325
93,2015-10-09,Pan,150000000,35088320,151525973,1525973,0.01007070253229788,-3.274926813252957,23.392213333333334
2,2014-04-18,Transcendence,100000000,23022309,103039258,3039258,0.029496116907208315,-3.343612971227169,23.022309
40,2012-04-27,Hodejegerne,5250000,1200010,20188740,14938740,0.7399540535962126,-3.3749635419704838,22.857333333333333
77,2011-10-21,The Three Musketeers,90000000,20377913,139877913,49877913,0.3565817642703891,-3.4165464834401833,22.642125555555555
90,2017-07-21,Valerian and the City of a Thousand Planets,180000000,40479370,215098356,35098356,0.1631735204893895,-3.446709521417947,22.48853888888889
70,2011-07-15,Snow Flower and the Secret Fan,6000000,1348205,11348205,5348205,0.47128202213477816,-3.4503617773261483,22.47008333333333
51,2004-11-24,Alexander,155000000,34297191,167297191,12297191,0.07350506560507641,-3.519320547271641,22.12722
56,2007-03-16,The Wind That Shakes the Barley,8300000,1829142,25670174,17370174,0.676667559791375,-3.537646612455457,22.037855421686746
27,2010-09-22,You Will Meet a Tall Dark Stranger,15000000,3247816,34247816,19247816,0.5620158669387852,-3.618488239481547,21.65210666666667
57,2004-10-22,The Machinist,5000000,1082044,8655397,3655397,0.42232574658331673,-3.620884178462244,21.640880000000003
38,2006-11-10,A Good Year,35000000,7459300,42064105,7064105,0.16793665287779208,-3.6921292882710173,21.312285714285714
99,2015-12-04,Youth,13000000,2703296,24001573,11001573,0.45836883274275386,-3.808944340538365,20.794584615384615
48,2007-04-06,Zwartboek,22000000,4398532,27238354,5238354,0.19231536531172186,-4.00166873857005,19.993327272727274
62,2005-06-10,Hauru no ugoku shiro,24000000,4710455,237814327,213814327,0.8990809330003066,-4.095049204376223,19.626895833333332
40,2017-10-20,The Snowman,35000000,6670765,43226146,8226146,0.19030486779922506,-4.246774545348247,19.059328571428573
20,2009-05-22,Easy Virtue,14000000,2656784,20537741,6537741,0.3183281452424587,-4.2695288740070705,18.977028571428573
6,2007-01-12,Arthur et les Minimoys,80000000,15132763,113325743,33325743,0.29407036845988294,-4.28654284746282,18.91595375
78,2012-09-07,The Cold Light of Day,20000000,3763583,25361206,5361206,0.21139396919846792,-4.314085008886479,18.817915
19,2011-10-21,Johnny English Reborn,45000000,8406711,164640401,119640401,0.7266770505497007,-4.352866299317295,18.68158
4,2015-04-24,The Water Diviner,22500000,4200117,31054727,8554727,0.2754726196755811,-4.3569936266061156,18.667186666666666
24,2015-02-06,Seventh Son,95000000,17725785,108874967,13874967,0.12743945998165032,-4.359424138338584,18.65872105263158
27,2005-07-01,De battre mon coeur s'est arrÃªtÃ©,5500000,1023424,8589831,3089831,0.3597080082250745,-4.374116690638484,18.60770909090909
25,2007-03-09,Gwoemul,12000000,2201923,92618117,80618117,0.8704357161569156,-4.4497818497740385,18.34935833333333
28,2011-04-01,Haevnen,5500000,1008098,15867314,10367314,0.6533754862354145,-4.455818779523419,18.329054545454547
66,2010-05-21,Kites,9200000,1685269,17155193,7955193,0.46371923650174035,-4.459069145637877,18.318141304347826
53,2013-08-23,Yi dai zong shi,38600000,6594959,57987299,19387299,0.3343369898984258,-4.852955264771168,17.085386010362694
57,2016-09-23,The Dressmaker,11900000,2022115,24041617,12141617,0.5050249739857349,-4.884927415107449,16.99256302521008
12,2013-12-20,Le passÃ©,8000000,1335672,15752575,7752575,0.4921465220765494,-4.989494426775436,16.695899999999998
1,2010-02-26,Un ProphÃ¨te,13000000,2087720,19910624,6910624,0.34708224111911307,-5.226888663230701,16.059384615384616
43,2004-12-17,Mar adentro,13300000,2086345,39686345,26386345,0.6648721367513184,-5.3747846113658095,15.686804511278197
2,2010-12-03,"I Love You, Phillip Morris",13000000,2037459,23014027,10014027,0.43512710748101585,-5.380496490972334,15.672761538461538
22,2006-12-21,Man cheng jin dai huang jin jia,45000000,6566773,76904429,31904429,0.4148581481568507,-5.852680913441047,14.59282888888889
71,2013-04-05,Trance,16000000,2322593,22594052,6594052,0.2918490229198375,-5.8888522440220905,14.51620625
89,2006-06-23,Krrish,10000000,1430721,32430721,22430721,0.6916503953149854,-5.989482925042688,14.307210000000001
29,2013-03-01,Stoker,12000000,1703125,12034913,34913,0.0029009765172378064,-6.045871559633028,14.192708333333334
3,2015-07-24,The Vatican Tapes,13000000,1784763,14929184,1929184,0.12922233391992488,-6.28388026869674,13.728946153846152
14,2010-11-19,Made in Dagenham,8000000,1095369,15644196,7644196,0.4886282427041952,-6.303474902064966,13.6921125
40,2017-03-17,T2: Trainspotting,18000000,2402004,42091262,24091262,0.5723577972074109,-6.493742724824771,13.344466666666666
41,2009-12-30,Das Weisse Band: Eine deutsche Kindergeschichte,18000000,2222862,25727044,7727044,0.3003471366551089,-7.097668681186686,12.349233333333332
31,2005-08-05,2046,12000000,1442338,19287485,7287485,0.3778349017510578,-7.31982517274037,12.019483333333334
34,2010-04-30,Housefull,10100000,1183658,18726300,8626300,0.4606515969518805,-7.532870136475232,11.719386138613862
27,2014-06-27,Snowpiercer,40000000,4563029,88069880,48069880,0.5458152094677544,-7.766106899605504,11.4075725
45,2004-11-26,Un long dimanche de fianÃ§ailles,55000000,6167817,69759296,14759296,0.2115746122208573,-7.917255489259814,11.214212727272727
20,2012-11-23,De rouille et dâos,19500000,2061449,29393634,9893634,0.33659104553047103,-8.45936571799739,10.571533333333333
7,2011-12-16,Carnage,25000000,2546747,38112154,13112154,0.34404127355278846,-8.816444271849539,10.186988
96,2006-12-29,Miss Potter,30000000,3005605,35891257,5891257,0.16414184100601437,-8.98135150826539,10.018683333333334
75,2008-07-25,Bienvenue chez les Ch'tis,16000000,1477650,247474497,231474497,0.9353468733386293,-9.828003925151423,9.2353125
35,2004-09-03,Tae Guik Gi: The Brotherhood of War,12500000,1110186,69826708,57326708,0.8209854028919708,-10.259374555254706,8.881488
41,2017-01-06,A Monster Calls,43000000,3740823,46414530,3414530,0.07356597169033059,-10.494796733232233,8.699588372093023
15,2016-08-05,Operation Chromite,12700000,1022720,49196532,36496532,0.7418517223937655,-11.417866082603254,8.052913385826772
10,2015-11-20,Legend,25000000,1872994,42425450,17425450,0.41073105883378963,-12.347613500096637,7.491976
20,2016-01-22,Yip Man 3,36000000,2679437,157300954,121300954,0.771139340960386,-12.435658311802069,7.442880555555556
42,2016-02-19,Mei Ren Yu,60720000,3229457,554516671,493796671,0.890499234422476,-17.8019224284454,5.318605072463768
51,2006-03-03,Joyeux NoÃ«l,22000000,1054361,23134075,1134075,0.04902184331986475,-19.865718667515207,4.79255
24,2006-12-27,Perfume: The Story of a Murderer,63700000,2223293,133603463,69903463,0.5232159513709611,-27.651194421967777,3.4902558869701727
19,2016-02-12,The Little Prince,77500000,1311213,102028919,24528919,0.24041143668296633,-58.10557628699532,1.6918877419354839
