id,release_date,movie,production_budget,domestic_gross,worldwide_gross,profit,profit_margin,domestic_profit_margin
8,2005-09-02,A Sound of Thunder,80000000,1900451,6300451,-73699549,-0.11697503718384604,-41.0952710698671
2,2015-04-17,Child 44,50000000,1224330,8004221,-41995779,-0.05246704082758335,-39.83866277882597
42,2019-06-14,Men in Black: International,110000000,3100000,3100000,-106900000,-0.34483870967741936,-34.483870967741936
21,2011-05-06,There Be Dragons,36000000,1069334,4020990,-31979010,-0.07953019032626293,-32.665814422808964
67,2010-05-28,Micmacs,42000000,1259693,11756922,-30243078,-0.025723635829173655,-32.34145700579427
68,2008-12-12,"Che, Part 1: The Argentine",58000000,1802521,31627370,-26372630,-0.008338546644883845,-31.17715632716623
19,2005-09-23,Oliver Twist,65000000,2070920,26670920,-38329080,-0.014371112807507202,-30.387016398508877
16,2008-10-17,What Just Happened,27000000,1090947,2412123,-24587877,-0.10193459040024079,-23.74913996738613
18,2006-12-15,The Good German,32000000,1308696,6678033,-25321967,-0.03791830169153103,-23.45182074370213
30,2016-11-11,Billy Lynnâs Long Halftime Walk,40000000,1738477,30230402,-9769598,-0.003231712896176504,-22.00864492311374
5,2002-08-16,The Adventures of Pluto Nash,100000000,4411102,7094995,-92905005,-0.13094442631742517,-21.670072013750758
13,2009-11-25,Me and Orson Welles,25000000,1190003,1190003,-23809997,-0.2000835039911664,-20.00835039911664
92,2008-05-23,The Children of Huang Shi,20000000,1031872,8221700,-11778300,-0.014325869345755742,-18.382248961111454
91,2012-08-29,The Oogieloves in the BIG Balloon Adventure,20000000,1065907,1065907,-18934093,-0.17763363032609786,-17.763363032609785
43,2013-03-01,Phantom,18000000,1034589,1199510,-16800490,-0.14006127502063342,-16.398213203504
90,2011-04-29,Dylan Dog: Dead of Night,20000000,1186538,6093725,-13906275,-0.02282064746932295,-15.855760203213045
89,2002-12-06,Equilibrium,20000000,1190018,5345869,-14654131,-0.027412065278816223,-15.806468473586113
12,2016-01-29,Jane Got a Gun,25000000,1513793,3771345,-21228655,-0.05628934769956077,-15.514807506706664
53,2001-04-27,Town & Country,105000000,6712451,10364769,-94635231,-0.09130471793437943,-14.642572288423409
11,2009-11-20,Bad Lieutenant: Port of Call New Orleans,25000000,1702112,12413949,-12586051,-0.010138635981185357,-13.687635126243162
23,2011-07-29,The Devil's Double,19100000,1361512,5965646,-13134354,-0.022016649999011,-13.028521232277056
70,2001-02-23,Monkeybone,75000000,5409517,5409517,-69590483,-0.12864454072332152,-12.864454072332151
50,2003-10-24,Beyond Borders,60000000,4426297,11427090,-48572910,-0.04250680619475299,-12.555348861587914
13,2017-02-24,Collide,29200000,2280004,5466698,-23733302,-0.043414327991046886,-11.806995075447237
7,2011-07-29,Attack the Block,13000000,1024175,6459183,-6540817,-0.010126384404962671,-11.69314326164962
49,2008-01-11,In the Name of the King: A Dungeon Siege Tale,60000000,4775656,13233220,-46766780,-0.03534043868385774,-11.563718994835474
87,2007-04-13,Slow Burn,15500000,1237615,1237615,-14262385,-0.11524088670547787,-11.524088670547787
37,2006-06-02,Banlieue 13,15000000,1200216,11599903,-3400097,-0.002931142613864961,-11.497750404927114
10,2016-06-10,Genius,17000000,1361045,7265283,-9734717,-0.01339895087362736,-11.490402595064822
24,2002-12-25,Pinocchio,45000000,3681811,31681811,-13318189,-0.0042037334923814805,-11.222246063146642
50,2010-10-08,Stone,22000000,1810078,4065020,-17934980,-0.044120274930996656,-11.154172361633034
88,2003-08-22,Marci X,20000000,1646664,1646664,-18353336,-0.11145768657115233,-11.145768657115234
82,2018-09-21,The Sisters Brothers,38000000,3143056,13143056,-24856944,-0.018912606017961117,-11.090144114517845
48,2006-03-31,Basic Instinct 2,70000000,5946136,35417162,-34582838,-0.00976442945936775,-10.772350985581225
36,2008-03-14,Funny Games,15000000,1294640,8200127,-6799873,-0.008292399617713237,-10.586232466168202
36,2010-04-16,The Perfect Game,12500000,1089445,3931367,-8568633,-0.02179555610046073,-10.473732037872495
67,2007-08-17,The Last Legion,67000000,5932060,25357771,-41642229,-0.01642188069290475,-10.294558719905059
6,2006-10-13,Infamous,13000000,1151330,2613717,-10386283,-0.039737595921823216,-10.291289204658959
4,2006-03-17,Find Me Guilty,13000000,1173673,2898225,-10101775,-0.03485504058518576,-10.076338980278152
78,2017-04-21,The Promise,90000000,8224288,10551417,-79448583,-0.07529660044712477,-9.943196541755347
28,2007-07-20,Sunshine,40000000,3688560,32030610,-7969390,-0.0024880543954673355,-9.844340338777192
9,2003-10-17,Veronica Guerin,17000000,1569918,9438074,-7561926,-0.008012149512707784,-9.828591047430503
87,2006-05-05,The Proposition,20000000,1903434,5313608,-14686392,-0.027639208613055386,-9.507325181750458
9,2006-01-06,BloodRayne,25000000,2405420,3711633,-21288367,-0.057355797300002447,-9.393195367129232
8,2017-09-01,Tulip Fever,25000000,2455635,6792768,-18207232,-0.026803847857014992,-9.180666100621632
32,2011-03-11,Kill the Irishman,12000000,1188194,1188194,-10811806,-0.09099360878779054,-9.099360878779054
80,2008-10-03,How to Lose Friends & Alienate People,28000000,2775593,12031443,-15968557,-0.013272353947901345,-9.087934362134506
94,2003-05-02,Owning Mahowny,10000000,1011054,1011054,-8988946,-0.08890668549849959,-8.89066854984996
23,2007-11-16,Love in the Time of Cholera,45000000,4617608,31077418,-13922582,-0.004479967415568435,-8.745305361563823
95,2005-08-17,Supercross,30000000,3102550,3252550,-26747450,-0.082235323054219,-8.669465439718941
74,2005-12-21,The White Countess,16000000,1669971,2814566,-13185434,-0.04684713025027659,-8.581004700081618
46,2007-05-04,Lucky You,55000000,5755286,6521829,-48478171,-0.0743321712360137,-8.556432121705159
35,2007-08-24,September Dawn,10100000,1066555,1066555,-9033445,-0.08469741363548997,-8.469741363548996
93,2014-03-21,50 to 1,10000000,1069454,1069454,-8930546,-0.08350565802736723,-8.350565802736723
86,2002-11-15,Ararat,15500000,1693000,1693000,-13807000,-0.0815534554046072,-8.15534554046072
35,2017-02-03,The Comedian,15000000,1658706,1658706,-13341294,-0.08043193911398402,-8.043193911398403
53,2011-12-13,George Balanchine\'s The Nutcracker,19000000,2119994,2119994,-16880006,-0.07962289515913723,-7.962289515913724
85,2015-11-13,My All-American,20000000,2246000,2246000,-17754000,-0.07904719501335708,-7.904719501335708
55,2003-08-01,Gigli,54000000,6087542,7126002,-46873998,-0.06577881678955465,-7.870575348802522
47,2015-01-16,Blackhat,70000000,8005980,19665004,-50334996,-0.025596229728709945,-7.743464260465302
94,2003-04-02,The Good Thief,30000000,3517797,6460758,-23539242,-0.036434180014171716,-7.528064581327461
84,2004-03-19,Bon Voyage,20000000,2353728,8361736,-11638264,-0.013918478172475188,-7.49715855018082
96,2009-06-26,ChÃ©ri,23000000,2715657,2715657,-20284343,-0.07469405377777827,-7.469405377777827
7,2005-08-26,Undiscovered,9000000,1069318,1069318,-7930682,-0.07416579539482175,-7.416579539482175
26,2001-04-06,Just Visiting,40000000,4777007,16172200,-23827800,-0.014733802451119821,-7.373443873957061
47,2016-04-22,A Hologram for the King,35000000,4212494,11846010,-23153990,-0.01954581331604481,-7.30861717547847
46,2014-05-09,Legends of Oz: Dorothyâs Return,70000000,8462347,20107933,-49892067,-0.02481213111263102,-7.271936851561393
25,2002-11-27,Extreme Ops,40000000,4835968,12624471,-27375529,-0.021684495928581876,-7.271353325745745
6,2018-04-13,Sgt. Stubby: An American Hero,25000000,3054285,3645957,-21354043,-0.05856910270746473,-7.185221745842316
3,2019-06-07,Dark Phoenix,350000000,42762350,149762350,-200237650,-0.013370359773334221,-7.184770013808876
5,2008-10-03,Blindness,25000000,3073392,20052958,-4947042,-0.0024669886607252656,-7.1343349628033135
44,2004-07-30,Thunderbirds,55000000,6768055,28231444,-26768556,-0.009481823175605187,-7.126411502270593
82,2017-11-03,LBJ,20000000,2468683,2507181,-17492819,-0.06977086616403044,-7.101485690953435
81,2018-10-26,Suspiria,20000000,2483472,7034615,-12965385,-0.018430838077137128,-7.053241590805131
50,2013-10-18,The Fifth Estate,26000000,3254172,6154172,-19845828,-0.032247762980950154,-6.989743627564861
22,2010-08-06,Flipped,14000000,1755212,4289993,-9710007,-0.02263408588312382,-6.976244465056073
93,2004-12-29,The Merchant of Venice,30000000,3765585,18765585,-11234415,-0.005986711845114341,-6.9668896067941635
30,2008-03-07,Married Life,12000000,1506998,2975188,-9024812,-0.030333585642319073,-6.962850647446115
72,2014-05-16,The Immigrant,16000000,2013456,7585011,-8414989,-0.011094234405197302,-6.946535707758203
91,2017-06-02,Churchill,10000000,1279681,7582196,-2417804,-0.0031887912156319887,-6.8144475068395955
48,2015-01-23,Mortdecai,60000000,7696134,30396134,-29603866,-0.00973935237948352,-6.796122052968412
90,2012-07-27,Killer Joe,10000000,1291645,4659110,-5340890,-0.011463326686856503,-6.7420653507736255
100,2004-01-30,The Big Bounce,50000000,6471394,6626115,-43373885,-0.06545899822143142,-6.7263105908866
81,2006-05-12,Goal! The Dream Begins,33000000,4283255,27610873,-5389127,-0.0019518133309294494,-6.704421053614599
92,2007-09-21,The Assassination of Jesse James by the Coward Robert Ford,30000000,3909149,15313631,-14686369,-0.009590389764517638,-6.674304560915943
47,2014-06-13,The Rover,8500000,1109199,3180252,-5319748,-0.016727441724743827,-6.663187579505571
7,2010-12-25,L'illusionniste,17000000,2231474,8609949,-8390051,-0.009744600113194632,-6.618282803205415
43,2006-09-22,All the King's Men,55000000,7221458,9521458,-45478542,-0.04776426257407216,-6.6161905255143765
15,2008-06-06,And When Did You Last See Your Father?,8000000,1071240,2476491,-5523509,-0.022303771748009585,-6.46798103132818
65,2010-12-03,The Warrior's Way,42000000,5666340,8514325,-33485675,-0.03932863145346226,-6.412191996950413
19,2016-11-23,Rules Donât Apply,26700000,3652206,3871448,-22828552,-0.05896644356323526,-6.310650056431647
33,2014-02-06,The Interview,44000000,6105175,12342632,-31657368,-0.025648798408637638,-6.207000618327894
90,2017-09-22,Stronger,30000000,4211129,8786752,-21213248,-0.024142308784861576,-6.123980291271058
94,2011-03-11,Mars Needs Moms,150000000,21392758,39549758,-110450242,-0.027926907163376327,-6.011718638615928
53,2007-03-23,Namastey London,8400000,1207007,6831069,-1568931,-0.002296757652425997,-5.959363118855151
24,2015-11-25,Victor Frankenstein,40000000,5775076,31124367,-8875633,-0.0028516669913319042,-5.926315774891966
13,2018-04-06,Lean on Pete,8000000,1163056,2455027,-5544973,-0.02258619966297723,-5.8784306172703635
44,2011-01-28,Biutiful,35000000,5101237,24687524,-10312476,-0.0041772014074801505,-5.861080949581445
32,2008-07-18,Transsiberian,15000000,2203641,6379575,-8620425,-0.013512538060920986,-5.806916371586842
49,2014-10-31,Before I Go to Sleep,22000000,3242457,19563579,-2436421,-0.0012453861330792284,-5.784978181669024
88,2010-04-16,The Joneses,10000000,1475746,3541565,-6458435,-0.018236104659945532,-5.776233850540676
28,2002-06-14,The Dangerous Lives of Altar Boys,12000000,1779284,1779284,-10220716,-0.05744285903768034,-5.7442859037680325
52,2004-02-20,Against the Ropes,39000000,5881504,6429865,-32570135,-0.05065446164110755,-5.630956979711312
70,2014-11-14,The Homesman,16000000,2429989,8217571,-7782429,-0.009470473695937643,-5.5843919458071625
31,2003-12-25,The Company,15000000,2281585,3396508,-11603492,-0.034163005062846905,-5.574377022990596
42,2016-12-23,Silence,46500000,7100177,23726626,-22773374,-0.009598235332743897,-5.549132507541714
23,2002-01-04,Impostor,40000000,6114237,7974607,-32025393,-0.04015921160754379,-5.542108197637742
22,2018-03-09,The Hurricane Heist,40000000,6115824,30963684,-9036316,-0.0029183594561939074,-5.540410580814621
80,2008-10-24,"Synecdoche, New York",20000000,3083538,4383538,-15616462,-0.035625246091171105,-5.486055952610281
30,2004-02-20,The Blue Butterfly,10400000,1610194,1610194,-8789806,-0.05458849057939602,-5.458849057939602
87,2002-12-27,Nicholas Nickleby,10000000,1562800,1562800,-8437200,-0.0539877143588431,-5.39877143588431
47,2017-02-24,Rock Dog,60000000,9420546,24148488,-35851512,-0.014846276089832206,-5.369057589655632
2,2004-07-23,A Home at the End of the World,6500000,1029017,1033810,-5466190,-0.05287422253605595,-5.316708081596319
5,2004-04-30,Bobby Jones: Stroke of Genius,17000000,2694071,2694071,-14305929,-0.05310152924700203,-5.310152924700203
48,2010-05-07,Mother and Child,7000000,1110509,6537179,-462821,-0.0007079827552526862,-5.303415821033418
4,2018-12-14,Mortal Engines,100000000,15951040,85287417,-14712583,-0.0017250590435866995,-5.2691837021285135
17,2016-12-25,Live by Night,65000000,10378555,21774432,-43225568,-0.019851524944485346,-5.262914249623382
4,2005-04-22,King's Ransom,25000000,4008527,4049527,-20950473,-0.05173560517067796,-5.236704904320216
99,2009-11-13,The Boat That Rocked,50000000,8017467,37472651,-12527349,-0.003343064519240979,-5.236383635879013
21,2002-04-05,Big Trouble,45000000,7262288,8488871,-36511129,-0.04301058291497185,-5.196394304384514
30,2016-09-09,The Disappointments Room,15000000,2423467,3503761,-11496239,-0.0328111392301016,-5.189479782476923
90,2011-10-28,Anonymous,27500000,4463292,15815509,-11684491,-0.007387995542856066,-5.161371471998695
29,2010-09-15,Never Let Me Go,15000000,2434652,11173718,-3826282,-0.003424358839197481,-5.161044781759364
32,2010-12-17,Casino Jack,12500000,2039869,2272186,-10227814,-0.045013101920353356,-5.127844484131089
85,2003-02-28,Spider,10000000,1641788,1641788,-8358212,-0.050909203867978085,-5.090920386797809
43,2003-09-26,Luther,35000000,5781086,32717063,-2282937,-0.000697781766046665,-5.05422579771344
98,2018-02-16,Early Man,50000000,8267544,45285890,-4714110,-0.0010409666233787169,-5.0477452554228925
15,2005-05-13,Mindhunters,27000000,4476235,16566235,-10433765,-0.006298211392027217,-5.031854895911407
97,2002-03-29,Death to Smoochy,50000000,8355815,8374062,-41625938,-0.04970817985345702,-4.98385675125646
21,2015-07-10,Baahubali: The Beginning,40000000,6738000,26736665,-13263335,-0.004960729021364482,-4.936479667557139
46,2005-08-12,The Great Raid,60000000,10166502,10597070,-49402930,-0.04661942404834543,-4.901734933018259
6,2006-08-18,Trust the Man,9000000,1530535,2548378,-6451622,-0.025316581762988063,-4.880296758976437
3,2005-02-18,Son of the Mask,100000000,17018422,59918422,-40081578,-0.006689358074216307,-4.875985446829324
5,2018-12-25,Destroyer,9000000,1533324,3681096,-5318904,-0.014449240117617144,-4.869600945397059
1,2009-11-13,The Messenger,6500000,1109660,1744952,-4755048,-0.02725030831793654,-4.85765009101887
72,2001-12-07,The Business of Strangers,6000000,1030920,1290920,-4709080,-0.036478480463545376,-4.820044232336166
42,2013-02-01,Bullet to the Head,55000000,9489829,22597969,-32402031,-0.014338470417407864,-4.795678720870524
96,2009-02-27,Street Fighter: The Legend of Chun-Li,50000000,8742261,12660287,-37339713,-0.029493575461598934,-4.719344229141638
74,2011-10-14,The Big Year,41000000,7204138,7684524,-33315476,-0.043353987833208665,-4.691173600505709
84,2011-06-24,A Better Life,10000000,1759252,1884251,-8115749,-0.0430714856990921,-4.684233981260218
20,2008-09-26,Miracle at St. Anna,45000000,7916887,9676497,-35323503,-0.03650443233744608,-4.684052330164621
79,2009-05-15,The Brothers Bloom,20000000,3531756,5531756,-14468244,-0.026154884633378624,-4.662905364923285
68,2016-06-24,The Neon Demon,7500000,1333124,3559803,-3940197,-0.011068581604094383,-4.625883263672397
38,2003-09-19,Anything Else,18000000,3203044,13203044,-4796956,-0.0036332197332675713,-4.619654303843469
83,2017-04-21,Free Fire,10000000,1799322,3793739,-6206261,-0.016359219756551517,-4.557648936655029
82,2015-06-05,Testament of Youth,10000000,1822250,6646669,-3353331,-0.005045130124578191,-4.487721223761833
2,2008-04-25,Deception,25000000,4598506,12850033,-12149967,-0.009455202955509919,-4.436548305036462
19,2013-08-16,Paranoia,40000000,7388654,16340767,-23659233,-0.014478655132895537,-4.413705933448772
7,2007-08-17,The Invasion,80000000,15074191,40147042,-39852958,-0.009926748276996349,-4.307084141364535
41,2002-11-06,Femme Fatale,35000000,6630252,16830252,-18169748,-0.010795885884536964,-4.278834047333344
37,2013-09-27,Metallica Through the Never,18000000,3419967,9082906,-8917094,-0.009817446090491302,-4.263208680083755
88,2018-08-31,Kin,30000000,5718096,10096821,-19903179,-0.019712322324026546,-4.2465016327113085
13,2002-10-18,Formula 51,27000000,5204007,5204007,-21795993,-0.04188309700582647,-4.188309700582647
26,2003-10-03,Wonderland,5500000,1060512,1060512,-4439488,-0.041861742252798644,-4.186174225279864
81,2013-05-03,The Iceman,10000000,1930282,3623609,-6376391,-0.017596796453480494,-4.180590193557211
24,2002-02-15,Last Orders,12000000,2326407,2326407,-9673593,-0.04158168798494846,-4.158168798494846
45,2001-08-10,Osmosis Jones,70000000,13596911,13596911,-56403089,-0.04148228152703213,-4.148228152703213
36,2016-11-25,Miss Sloane,18000000,3500605,7719630,-10280370,-0.013317179709390217,-4.141968316905221
39,2016-03-11,The Brothers Grimsby,35000000,6864016,28720470,-6279530,-0.0021864300967219547,-4.0990557131568455
42,2014-04-04,Under the Skin,13300000,2614251,7229933,-6070067,-0.008395744469554559,-4.087499249306972
45,2008-07-11,Meet Dave,60000000,11803254,50648806,-9351194,-0.001846281233164707,-4.083343965994462
77,2007-11-21,Iâm Not There,20000000,4017609,12397613,-7602387,-0.0061321376945707206,-3.978085224321232
28,2015-10-23,Rock the Kasbah,15000000,3020665,3386153,-11613847,-0.03429805741205433,-3.9657939559666495
71,2018-09-14,Mandy,6000000,1214525,1427656,-4572344,-0.03202693085729335,-3.94020296000494
94,2005-10-14,Domino,50000000,10169202,23574057,-26425943,-0.011209756131496584,-3.9168066481519395
46,2009-09-25,I Hope They Serve Beer in Hell,7000000,1429299,1429453,-5570547,-0.03896978074830022,-3.897505700346813
44,2002-09-20,Ballistic: Ecks vs. Sever,70000000,14294842,14294842,-55705158,-0.038968711931198684,-3.896871193119868
1,2005-12-07,The World's Fastest Indian,25000000,5128124,18991288,-6008712,-0.003163930745508151,-3.8750771237200974
69,2007-10-19,Things We Lost in the Fire,16000000,3287315,8120148,-7879852,-0.009704074359235816,-3.86719404742168
35,2016-03-18,Midnight Special,18000000,3712282,7680250,-10319750,-0.013436737085381336,-3.8487695708461804
80,2008-10-10,City of Ember,38000000,7873007,17831558,-20168442,-0.011310532708358967,-3.8266183429025276
43,2014-02-14,Winterâs Tale,60000000,12600231,29575033,-30424967,-0.010287382265980905,-3.76181746191796
16,2014-08-22,Sin City: A Dame to Kill For,65000000,13757804,40650842,-24349158,-0.005989828697767196,-3.7245912210989487
91,2011-02-25,Drive Angry,50000000,10721033,41042583,-8957417,-0.0021824691199381872,-3.663729698434843
42,2006-09-22,Flyboys,60000000,13090630,14816379,-45183621,-0.03049572436018274,-3.583431049536959
41,2004-06-16,Around the World in 80 Days,110000000,24004159,72004159,-37995841,-0.005276895324893663,-3.5825392174747717
37,2003-09-05,The Order,35000000,7659747,11559747,-23440253,-0.02027747925625016,-3.569341520026706
12,2013-12-25,47 Ronin,175000000,38362475,151716815,-23283185,-0.0015346476262370788,-3.5617494700224634
47,2005-11-23,The Libertine,22000000,4835065,9448623,-12551377,-0.013283816065049903,-3.550093949098926
100,2001-03-23,Say It Isn't So,25000000,5516708,5516708,-19483292,-0.03531688100947159,-3.531688100947159
32,2005-03-04,The Jacket,28500000,6301131,15452978,-13047022,-0.008443047029511076,-3.5229975380610243
19,2001-09-07,Soul Survivors,14000000,3100650,4288246,-9711754,-0.02264738077059945,-3.515182300485382
76,2008-10-03,Flash of Genius,20000000,4442377,4504111,-15495889,-0.03440387903406466,-3.5020942616981854
4,2016-08-26,Greater,9000000,2000093,2000093,-6999907,-0.03499790759729672,-3.4997907597296725
18,2016-02-26,Gods of Egypt,140000000,31153464,138836756,-1163244,-8.378501727597266e-05,-3.493882285449862
75,2008-10-24,Passchendaele,20000000,4452423,4453327,-15546673,-0.03491024351007685,-3.491936188452894
34,2017-08-25,Birth of the Dragon,31000000,6901965,7220490,-23779510,-0.032933374327781074,-3.491474529355046
11,2017-05-12,King Arthur: Legend of the Sword,175000000,39175066,139630336,-35369664,-0.002533093095185275,-3.4671271262184984
40,2010-06-18,Jonah Hex,47000000,10547117,11022696,-35977304,-0.032639296230250754,-3.4561940480986415
99,2005-09-02,Underclassman,25000000,5654777,5654777,-19345223,-0.03421040829726796,-3.421040829726796
63,2001-02-02,Left Behind,18500000,4221341,4221341,-14278659,-0.03382493619918409,-3.3824936199184097
36,2008-12-05,Punisher: War Zone,35000000,8050977,10157534,-24842466,-0.02445718222552836,-3.3472984707321856
87,2002-09-20,Trapped,30000000,6916869,6916869,-23083131,-0.03337222520767705,-3.3372225207677055
21,2005-07-29,Stealth,138000000,32116746,76416746,-61583254,-0.008058868929069552,-3.296823843860147
45,2013-11-15,The Christmas Candle,7000000,1632000,1933829,-5066171,-0.026197616231838493,-3.2892156862745097
40,2003-02-21,Gods and Generals,55000000,12882934,12923936,-42076064,-0.03255669480257408,-3.2692138297068043
24,2001-07-11,Final Fantasy: The Spirits Within,137000000,32131830,85131830,-51868170,-0.0060926882459827305,-3.263684950405875
26,2007-01-26,Blood and Chocolate,15000000,3526588,6551310,-8448690,-0.012896184121954235,-3.2534030059649726
98,2001-03-02,The Widow of St. Pierre,13000000,3058380,3058380,-9941620,-0.032506163393692084,-3.2506163393692087
74,2016-08-26,Hands of Stone,20000000,4712792,5031975,-14968025,-0.029745825446271093,-3.243768874162068
69,2009-02-06,Polytechnique,6000000,1418304,1418304,-4581696,-0.032304047651279276,-3.2304047651279273
97,2010-03-26,Chloe,13000000,3075255,11831131,-1168869,-0.0009879604916892561,-3.227291720523989
76,2011-08-19,Conan the Barbarian,90000000,21295021,63356133,-26643867,-0.004205412442075655,-3.2263400444639148
44,2007-02-02,Factory Girl,7000000,1661464,1661464,-5338536,-0.03213151774579528,-3.2131517745795275
35,2013-11-29,Mandela: Long Walk to Freedom,35000000,8323085,29890402,-5109598,-0.0017094443895401606,-3.205171519935216
97,2019-03-15,Captive State,25000000,5958315,8993300,-16006700,-0.01779847219596811,-3.1958171060106757
18,2018-12-21,Welcome to Marwen,45000000,10763520,12874922,-32125078,-0.02495166805670745,-3.1807884409561185
18,2003-09-26,Duplex,40000000,9652000,10070651,-29929349,-0.029719378618125084,-3.144218814753419
1,2003-11-26,Timeline,80000000,19480739,26703184,-53296816,-0.019958974180756872,-3.106620390530359
35,2004-04-09,The Alamo,92000000,22406362,23911362,-68088638,-0.02847543272524584,-3.105976686442895
96,2007-08-24,Resurrecting the Champ,13000000,3172382,3260555,-9739445,-0.02987051284213884,-3.0978671547121372
100,2009-12-18,Nine,80000000,19676965,53508858,-26491142,-0.004950795623408745,-3.065667647424285
78,2015-10-30,Our Brand is Crisis,28000000,7002261,8594558,-19405442,-0.022578755068032582,-2.9987084171812506
86,2011-01-14,Barney's Version,30000000,7502560,8845575,-21154425,-0.023915262716103815,-2.998635132541426
1,2015-12-11,In the Heart of the Sea,100000000,25020758,89693309,-10306691,-0.0011491036639087538,-2.996681475437315
73,2004-10-29,Birth,20000000,5005899,14603001,-5396999,-0.003695814990357119,-2.995286361151114
1,2010-12-17,How Do You Know?,120000000,30212620,49628177,-70371823,-0.014179812206279509,-2.9718501738677414
78,2011-09-09,Bucky Larson: Born to Be a Star,10000000,2529395,2529395,-7470605,-0.029535145756198616,-2.9535145756198617
35,2001-02-23,3000 Miles to Graceland,62000000,15738632,18708848,-43291152,-0.02313940013837303,-2.939351272715443
61,2004-12-17,Beyond the Sea,24000000,6144806,8292914,-15707086,-0.018940370055688507,-2.9057376262163523
28,2009-08-26,Taking Woodstock,29000000,7460204,10066366,-18933634,-0.018808807468355514,-2.8872931624926075
17,2009-09-25,Pandorum,40000000,10330853,17033431,-22966569,-0.013483231299671805,-2.8718971221447056
55,2013-07-19,R.I.P.D.,130000000,33618855,79076678,-50923322,-0.006439739666352702,-2.8668776792070996
52,2006-04-28,The Lost City,9600000,2484186,5256839,-4343161,-0.008261925084637365,-2.864444932867346
72,2005-01-28,Alone in the Dark,20000000,5178569,10588079,-9411921,-0.008889167713992311,-2.8620707766952607
71,2009-08-14,Bandslam,20000000,5210988,12967829,-7032171,-0.005422782024655014,-2.838043764445437
88,2008-10-10,The Express,37500000,9793406,9813309,-27686691,-0.028213409972110325,-2.829107054277133
99,2003-11-14,Looney Tunes: Back in Action,80000000,20950820,54540662,-25459338,-0.004667955442124996,-2.8184662939207152
84,2017-02-03,The Space Between Us,30000000,7885294,16481405,-13518595,-0.008202331658010951,-2.8045505976061262
10,2006-01-27,Tristram Shandy: A Cock and Bull Story,4750000,1253413,3061763,-1688237,-0.005513937558197679,-2.7896527321800555
50,2018-06-01,Action Point,19000000,5059608,5103675,-13896325,-0.027228075847306105,-2.755231630592726
89,2004-06-25,Two Brothers,72000000,19176754,62176754,-9823246,-0.0015798904523063395,-2.75454573803262
22,2011-09-23,Red State,4000000,1065429,1983596,-2016404,-0.010165396582771895,-2.7543562264590133
15,2015-03-20,The Gunman,40000000,10664749,18594227,-21405773,-0.011512053176504729,-2.750674300914161
81,2017-01-13,Monster Trucks,125000000,33370166,61642798,-63357202,-0.0102781191080911,-2.745860898624238
42,2014-01-10,The Legend of Hercules,70000000,18848538,58953319,-11046681,-0.0018738013715563664,-2.7138158938374954
41,2011-10-21,The Mighty Macs,7000000,1891936,1891936,-5108064,-0.02699913739153968,-2.6999137391539674
41,2002-02-08,Rollerball,70000000,18990542,25852508,-44147492,-0.017076676661312705,-2.6860454009158876
40,2002-02-15,Hart's War,70000000,19076815,33076815,-36923185,-0.011162859846088566,-2.6693756269062736
45,2001-09-21,Megiddo: Omega Code 2,22000000,6047691,6047691,-15952309,-0.026377519949349268,-2.6377519949349266
70,2006-07-07,A Scanner Darkly,20000000,5501616,7405084,-12594916,-0.017008471477163528,-2.635295520443448
44,2017-12-08,Just Getting Started,22000000,6069605,6756412,-15243588,-0.02256166142621261,-2.6246180764646136
12,2007-11-02,Martian Child,27000000,7500310,9352089,-17647911,-0.01887055501717317,-2.599851206150146
23,2016-08-19,Ben-Hur,95000000,26410477,91669648,-3330352,-0.00036329931145803024,-2.597057334481312
49,2012-09-28,Won't Back Down,19000000,5310554,5745503,-13254497,-0.023069341361409087,-2.5777811505164996
67,2004-12-17,Flight of the Phoenix,75000000,21009180,34009180,-40990820,-0.012052869254712993,-2.5698680291186995
83,2005-09-09,An Unfinished Life,30000000,8535575,18535575,-11464425,-0.006185092720349922,-2.5147017043374347
55,2019-01-25,The Kid Who Would Be King,59000000,16790790,28348446,-30651554,-0.010812428307357659,-2.513831094308249
95,2018-12-07,Ben is Back,13000000,3703182,9633111,-3366889,-0.003495121150373955,-2.5104944882536153
69,2011-11-23,A Dangerous Method,20000000,5702083,14807531,-5192469,-0.0035066406411710365,-2.5074901575441815
82,2017-04-14,The Lost City of Z,30000000,8574339,17121823,-12878177,-0.007521498732932818,-2.498811978392737
96,2007-04-06,The Hoax,25000000,7164995,7164995,-17835005,-0.024891859659357755,-2.4891859659357753
68,2014-12-31,A Most Violent Year,20000000,5749134,8846875,-11153125,-0.012606852702225361,-2.478784804807124
49,2001-08-24,The Curse of the Jade Scorpion,26000000,7496522,18496522,-7503478,-0.004056696713036104,-2.468275021403259
77,2006-06-02,Peaceful Warrior,10000000,2893666,3260179,-6739821,-0.02067316242451718,-2.455823858040285
34,2006-11-22,The Fountain,35000000,10144010,15461638,-19538362,-0.012636670189794898,-2.4503120560803864
4,2012-08-24,The Apparition,17000000,4936819,10637281,-6362719,-0.005981527610298159,-2.4435129179335924
16,2011-10-28,The Rum Diary,45000000,13109815,21544732,-23455268,-0.010886776405480468,-2.4325427170406293
19,2005-03-04,Dear Frankie,4600000,1340891,3099369,-1500631,-0.004841730687762574,-2.430554757993006
32,2015-03-06,Unfinished Business,35000000,10219501,13214051,-21785949,-0.01648695695211105,-2.424824754163633
31,2009-09-11,Whiteout,35000000,10275638,12254746,-22745254,-0.018560363470609673,-2.406114540041212
40,2002-10-18,Auto Focus,7000000,2062066,2703821,-4296179,-0.015889287789391384,-2.3946537113749025
39,2009-06-12,Imagine That,55000000,16222392,22438144,-32561856,-0.014511831281589066,-2.39037547607036
15,2012-09-21,Dredd,45000000,13414714,41467606,-3532394,-0.0008518442082236432,-2.354525485970107
67,2012-10-26,Chasing Mavericks,20000000,6002756,8300821,-11699179,-0.014094002267968433,-2.331802925189696
29,2014-03-28,Sabotage,35000000,10508518,18376443,-16623557,-0.00904612334389196,-2.3306313982618674
13,2009-10-23,Astro Boy,65000000,19551067,41636243,-23363757,-0.005611398943944102,-2.3246267326484022
76,2001-08-24,John Carpenterâs Ghosts of Mars,28000000,8434601,8434601,-19565399,-0.023196591042065888,-2.319659104206589
81,2004-09-24,First Daughter,30000000,9055010,10419084,-19580916,-0.018793318107426717,-2.313083033591349
14,2008-11-07,Soul Men,40000000,12082391,12345883,-27654117,-0.022399464663645362,-2.3106030089574157
66,2002-05-03,Hollywood Ending,16000000,4839383,14839383,-1160617,-0.0007821194452626501,-2.3062065969980057
39,2001-10-19,The Last Castle,60000000,18208078,20541668,-39458332,-0.019208923053376195,-2.2952407167851545
95,2018-10-12,Beautiful Boy,25000000,7634767,13031424,-11968576,-0.009184396118183247,-2.2744941659647244
17,2006-10-27,Catch a Fire,14000000,4299773,5782198,-8217802,-0.014212245931391487,-2.2559858392524443
9,2018-11-21,Robin Hood,99000000,30824628,84747441,-14252559,-0.0016817686565898785,-2.2117175915310314
100,2005-10-21,The Work and the Glory: American Zion,6500000,2025032,2025032,-4474968,-0.02209825820036424,-2.209825820036424
74,2014-11-14,Rosewater,10000000,3128941,3185717,-6814283,-0.0213901077842131,-2.1959694989454897
28,2009-12-18,The Young Victoria,35000000,11001272,31878891,-3121109,-0.0009790519375344644,-2.1814502904755013
65,2016-11-18,Bleed for This,16000000,5083906,6603926,-9396074,-0.014228012246048789,-2.1471864349970278
39,2002-11-27,Solaris,47000000,14970038,14970038,-32029962,-0.02139604588846067,-2.139604588846067
11,2004-08-27,Suspect Zero,27000000,8712564,8712564,-18287436,-0.020989729315044343,-2.0989729315044343
65,2015-04-24,Little Boy,20000000,6485961,17769299,-2230701,-0.0012553680367469759,-2.0835831421126336
13,2013-07-02,The Lone Ranger,275000000,89302115,260002115,-14997885,-0.0005768370384217835,-2.0794343448640604
32,2016-07-13,The Infiltrator,47500000,15436808,20718104,-26781896,-0.01292680836045615,-2.0770610089857957
78,2002-09-27,Moonlight Mile,21000000,6830957,6830957,-14169043,-0.02074239817349165,-2.074239817349165
27,2001-12-25,The Shipping News,35000000,11405825,24405825,-10594175,-0.004340838713708715,-2.0686074878406426
51,2007-09-07,Shoot 'Em Up,39000000,12796824,26796824,-12203176,-0.004553963559263591,-2.0476311934898845
2,2007-06-01,Gracie,9000000,2956339,3922043,-5077957,-0.012947224189025974,-2.044305812019528
64,2008-02-01,Strange Wilderness,20000000,6575282,6947084,-13052916,-0.018789057394440603,-2.0416946375836047
21,2008-02-22,Charlie Bartlett,12000000,3950294,5295909,-6704091,-0.012658999616496431,-2.0377485827637134
38,2008-12-25,The Spirit,60000000,19806188,39006188,-20993812,-0.0053821747462223166,-2.029356279966645
13,2002-08-30,FearDotCom,40000000,13208023,13208023,-26791977,-0.020284623217267265,-2.0284623217267264
64,2012-11-13,Jab Tak Hai Jaan,9200000,3047539,5806666,-3393334,-0.005843859453944829,-2.018829291438108
21,2005-09-16,Thumbsucker,4000000,1328679,1919197,-2080803,-0.010842050086572665,-2.0105089340615754
79,2008-03-14,Doomsday,33000000,11008770,21621188,-11378812,-0.005262806095576247,-1.9976100872304536
71,2012-10-12,Atlas Shrugged: Part II,10000000,3336053,3336053,-6663947,-0.01997554295450342,-1.997554295450342
60,2013-12-20,Dhoom 3,24000000,8031955,11723620,-12276380,-0.010471492593584575,-1.988064549664434
12,2004-11-05,Alfie,40000000,13395939,35195939,-4804061,-0.0013649475298840585,-1.9859795569388603
38,2008-05-02,Redbelt,7000000,2344847,2667084,-4332916,-0.016245892517820965,-1.9852694013724563
20,2005-12-14,Los tres entierros de Melquiades Estrada,15000000,5027684,13454474,-1545526,-0.001148707857326864,-1.9834810620556105
31,2012-04-06,Damsels in Distress,3000000,1007535,1324299,-1675701,-0.012653494414780952,-1.97756405484673
38,2007-01-05,Happily N'Ever After,47000000,15849032,37923818,-9076182,-0.002393266943744957,-1.9654807940320898
68,2001-11-16,Novocaine,6000000,2025238,2522928,-3477072,-0.013781891516523656,-1.9626147642894316
79,2011-04-29,Hoodwinked Too: Hood vs. Evil,30000000,10143779,23353111,-6646889,-0.0028462541885747043,-1.957477681641132
69,2016-03-30,Everybody Wants Some,10000000,3400278,5437126,-4562874,-0.008392069633847,-1.9409360058207006
93,2019-01-25,Serenity,25000000,8547045,11367029,-13632971,-0.01199343381634726,-1.9249875249282062
26,2006-08-11,Zoom,35000000,11989328,12506188,-22493812,-0.017986145738413655,-1.919262864440776
63,2003-03-14,Willard,20000000,6882696,6882696,-13117304,-0.01905838061131859,-1.9058380611318588
40,2018-11-09,The Girl in the Spiderâs Web,43000000,14828555,34983342,-8016658,-0.002291564367978337,-1.899810534472172
67,2008-07-03,The Wackness,6000000,2077046,3330012,-2669988,-0.00801795308845734,-1.8887179195838706
30,2010-05-21,Solitary Man,12500000,4360548,4360548,-8139452,-0.01866612178102385,-1.8666121781023852
99,2013-05-31,The East,6500000,2274649,3027956,-3472044,-0.011466626331426215,-1.8575837414915444
10,2004-05-07,New York Minute,40000000,14018364,21215882,-18784118,-0.008853800186105862,-1.853400011584804
62,2008-10-03,An American Carol,20000000,7013191,7022183,-12977817,-0.018481171738190246,-1.8517689023441684
9,2009-10-23,Cirque du Freak: The Vampire's Assistant,40000000,14046595,39753957,-246043,-6.189144894431516e-05,-1.8476652170864185
89,2007-10-19,Rendition,27500000,9736045,26939925,-560075,-0.00020789775769605894,-1.8245555561832345
98,2010-03-12,Green Zone,100000000,35497337,97523020,-2476980,-0.0002539892632529222,-1.8171127315832172
11,2002-06-14,Windtalkers,115000000,40914068,77628265,-37371735,-0.004814191712258415,-1.810769146690571
8,2009-10-23,Amelia,40000000,14279575,19756077,-20243923,-0.01024693465205668,-1.801203817340502
20,2011-06-17,The Art of Getting By,4000000,1430241,1989035,-2010965,-0.0101102544701325,-1.7967314599427648
38,2011-09-23,Killer Elite,70000000,25124986,65409046,-4590954,-0.0007018836507720966,-1.7860712041789795
62,2017-12-22,Downsizing,68000000,24449754,54462971,-13537029,-0.00248554729047007,-1.7812140768369285
5,2002-04-26,"Life, or Something Like It",40000000,14448589,14448589,-25551411,-0.017684364196393156,-1.7684364196393156
78,2013-03-08,Dead Man Down,30000000,10895295,19599974,-10400026,-0.005306142753046509,-1.7534821223289503
48,2011-03-04,Take Me Home Tonight,19000000,6928068,7576604,-11423396,-0.015077198174802329,-1.7424673083462807
77,2001-01-12,Antitrust,30000000,10965209,17865209,-12134791,-0.006792414799065603,-1.7359259636546827
23,2003-03-28,The Core,85000000,31111260,74132631,-10867369,-0.001465935965499457,-1.7321297819503292
99,2008-05-09,Speed Racer,120000000,43945766,93394462,-26605538,-0.0028487275830123633,-1.7306384874483698
25,2010-01-15,The Last Station,18000000,6617867,15696146,-2303854,-0.0014677832379999523,-1.719909602293307
66,2003-10-31,Shattered Glass,6000000,2207975,3456602,-2543398,-0.007358087509062368,-1.717422072260782
2,2003-09-26,The Gospel of John,11000000,4068087,4234355,-6765645,-0.015977982479031635,-1.7039736367486733
22,2010-08-13,Scott Pilgrim vs. The World,85000000,31611316,48056764,-36943236,-0.007687416489383263,-1.6889105154622477
10,2005-07-01,Rebound,45000000,16809014,17492014,-27507986,-0.015726025602312003,-1.6771350181515703
94,2007-05-04,"Paris, je t'aime",13000000,4857374,5175088,-7824912,-0.015120345779627321,-1.6763432257841377
12,2005-01-14,Elektra,65000000,24409722,56824633,-8175367,-0.0014387012407101687,-1.6628734239578804
86,2005-09-30,Into the Blue,50000000,18782227,41982227,-8017773,-0.001909801735863131,-1.6620911354122172
57,2010-03-19,The Runaways,9500000,3573673,5278632,-4221368,-0.00799708712408821,-1.6583293994721957
61,2005-09-16,Proof,20000000,7535331,8284331,-11715669,-0.014141961493329998,-1.6541634335638342
36,2006-09-15,The Black Dahlia,60000000,22672813,49238525,-10761475,-0.0021855802951042907,-1.6463412369695811
93,2002-02-01,Birthday Girl,13000000,4919896,8130727,-4869273,-0.005988730159062036,-1.6423322769424393
25,2001-08-17,American Outlaws,35000000,13264986,13601109,-21398891,-0.01573319572690727,-1.6385252121638123
97,2002-11-27,Treasure Planet,100000000,38120554,91800000,-8200000,-0.0008932461873638346,-1.6232567344115723
68,2016-10-14,Max Steel,10000000,3818664,4563080,-5436920,-0.011915022309492712,-1.6187169125118104
100,2007-03-09,The Ultimate Gift,9000000,3438735,3438735,-5561265,-0.01617241514684906,-1.617241514684906
92,2001-08-24,Bubble Boy,13000000,5002310,5002310,-7997690,-0.015987993546981293,-1.5987993546981294
17,2016-03-11,The Young Messiah,16800000,6469813,7313697,-9486303,-0.012970598864021847,-1.5966747416038145
88,2001-12-21,The Majestic,72000000,27796042,37306334,-34693666,-0.009299671739388813,-1.5902968487383924
21,2007-03-02,Zodiac,85000000,33080084,83080084,-1919916,-0.00023109220736945813,-1.5695218911777855
74,2016-02-05,Pride and Prejudice and Zombies,28000000,10907291,16638300,-11361700,-0.006828642349278472,-1.5670902151597497
75,2002-07-19,K-19: The Widowmaker,90000000,35168966,65716126,-24283874,-0.003695268646846285,-1.559074383932698
47,2016-09-30,Deepwater Horizon,156000000,61433527,122603824,-33396176,-0.0027239098186692774,-1.5393300306524806
36,2016-01-29,The Finest Hours,70000000,27569558,49252761,-20747239,-0.004212401209345401,-1.539032363159395
84,2003-02-21,The Life of David Gale,50000000,19694635,28920188,-21079812,-0.007288960915468461,-1.5387624599288081
83,2005-02-25,Man of the House,50000000,19699706,22099706,-27900294,-0.012624735369782748,-1.538108944366987
58,2013-10-11,Machete Kills,20000000,8008161,18273009,-1726991,-0.0009451048811938964,-1.4974522864862483
63,2013-11-27,Black Nativity,17500000,7018188,7285135,-10214865,-0.014021517789306579,-1.493521119696423
95,2004-07-23,Catwoman,100000000,40202379,82145379,-17854621,-0.0021735393052359038,-1.487414986063387
57,2004-04-16,Connie & Carla,20000000,8047525,8047525,-11952475,-0.014852361440318606,-1.4852361440318607
33,2010-01-22,Extraordinary Measures,31000000,12482741,15826984,-15173016,-0.009586801882152657,-1.4834289199783925
65,2003-06-13,Hollywood Homicide,75000000,30207785,50409753,-24590247,-0.004878073296649559,-1.482803687857286
35,2005-10-21,Doom,70000000,28212337,58757178,-11242822,-0.001913438048369171,-1.4811840295258063
3,2006-02-24,Running Scared,17000000,6855137,9729088,-7270912,-0.007473374688357222,-1.4798920867664642
90,2002-08-16,Possession,25000000,10103647,14805812,-10194188,-0.006885261004259679,-1.4743540624489355
56,2014-12-12,Inherent Vice,20000000,8110975,14772346,-5227654,-0.003538810964758069,-1.4657948027210046
55,2007-01-05,Code Name: The Cleaner,20000000,8135024,8135024,-11864976,-0.01458505346757428,-1.458505346757428
66,2016-09-30,Denial,10000000,4073448,9263940,-736060,-0.0007945431425505778,-1.4549227092134231
17,2003-06-20,From Justin to Kelly,12000000,4922166,4922166,-7077834,-0.014379510971389424,-1.4379510971389424
82,2009-09-04,Gamer,50000000,20534907,42002029,-7997971,-0.0019041868191653313,-1.4348783269386123
88,2011-09-16,Straw Dogs,25000000,10324441,11253821,-13746179,-0.012214677130549705,-1.4214386037946267
73,2007-06-29,Evening,30000000,12406646,12885574,-17114426,-0.013281849919918196,-1.4180588371748497
11,2003-11-26,The Missing,65000000,26900336,38253433,-26746567,-0.006991938997997906,-1.4163266956962917
91,2010-02-12,The Wolfman,150000000,62189884,142634358,-7365642,-0.0005164002631119214,-1.4119678370842434
21,2006-12-20,The Painted Veil,19400000,8060487,15118795,-4281205,-0.002831710463697669,-1.4068024673943398
2,2008-01-25,How She Move,17000000,7070641,8607815,-8392185,-0.009749495080923556,-1.4043081808283011
81,2016-06-24,Free State of Jones,50000000,20810036,23237252,-26762748,-0.011517174233855192,-1.4026868574374403
54,2005-09-09,The Man,20000000,8330720,10393696,-9606304,-0.009242433105605552,-1.4007528761019457
54,2007-01-05,Thr3e,2400000,1008849,1420418,-979582,-0.006896434711472257,-1.3789486831032196
72,2005-12-25,The New World,30000000,12712093,26184400,-3815600,-0.0014572035257634317,-1.359957561669821
34,2005-07-08,Dark Water,60000000,25473093,49473093,-10526907,-0.002127804501731881,-1.3554265671624566
17,2009-08-21,Post Grad,15000000,6382178,6563402,-8436598,-0.012854001629033234,-1.350294836652942
80,2011-09-30,Dream House,50000000,21302340,41642166,-8357834,-0.0020070603435949994,-1.34715998336333
65,2012-03-16,"Jeff, Who Lives at Home",10000000,4269426,4708127,-5291873,-0.011239868848057838,-1.342235232558194
16,2008-08-20,The Rocker,15000000,6409528,8767338,-6232662,-0.0071089559909746835,-1.3402659290980552
64,2018-06-15,Gotti,10000000,4286367,6089100,-3910900,-0.0064227882609909515,-1.3329780207807684
87,2002-10-18,Abandon,25000000,10719367,12219367,-12780633,-0.010459324938845032,-1.332227266777973
22,2004-10-15,Being Julia,18000000,7739049,14488705,-3511295,-0.002423470558617903,-1.3258671705011817
1,2006-04-21,American Dreamz,17000000,7314027,16510971,-489029,-0.0002961842765031808,-1.324300963067268
34,2002-06-07,Bad Company,70000000,30157016,69157016,-842984,-0.00012189421243970389,-1.3211845628227938
8,2005-12-16,The Producers: The Movie Musical,45000000,19398532,32952995,-12047005,-0.0036558148963394678,-1.31976316558387
10,2005-11-11,Zathura,65000000,28045540,58545540,-6454460,-0.001102468266583586,-1.3176590645072264
79,2016-09-16,Snowden,50000000,21587519,35380918,-14619082,-0.004131911444468457,-1.3161531438605798
78,2011-04-08,Your Highness,50000000,21596445,26121638,-23878362,-0.009141219245133097,-1.3151958574663563
71,2004-09-03,Wicker Park,30000000,13001257,21577076,-8422924,-0.0039036447755942468,-1.3074691931710911
13,2010-03-19,Repo Men,32000000,13942007,18195238,-13804762,-0.007587019197000886,-1.295221914606699
63,2001-10-26,On the Line,10000000,4365455,4690802,-5309198,-0.011318316142953805,-1.2907119647321985
85,2008-03-28,Stop-Loss,25000000,10915744,11229035,-13770965,-0.01226371188619503,-1.2902699073924782
53,2015-10-23,Jem and the Holograms,5000000,2184640,2368937,-2631063,-0.01110651317447446,-1.288706606122748
1,2002-02-01,Slackers,11000000,4814244,5942218,-5057782,-0.008511606272270725,-1.2848862666703225
77,2019-04-12,Hellboy,50000000,21903748,40725492,-9274508,-0.0022773225182890363,-1.2827143555523008
7,2001-01-19,The Pledge,45000000,19719930,29406132,-15593868,-0.005302930694863235,-1.281955361910514
52,2016-04-29,Ratchet and Clank,20000000,8813410,14365639,-5634361,-0.00392210955600374,-1.2692692158880614
6,2019-05-03,UglyDolls,45000000,19894664,24644664,-20355336,-0.008259530744667487,-1.261913043618128
46,2008-10-17,Sex Drive,19000000,8402485,10412485,-8587515,-0.00824732520623079,-1.2612358129767562
76,2003-04-16,Bulletproof Monk,52000000,23010607,23010607,-28989393,-0.01259827391776323,-1.259827391776323
51,2013-09-20,Battle of the Year,20000000,8888355,16723377,-3276623,-0.0019593070227382904,-1.2501351487423713
66,2004-11-24,The Work and the Glory,7500000,3347647,3347647,-4152353,-0.012403795860196729,-1.240379586019673
19,2002-03-15,Showtime,85000000,37948765,78948765,-6051235,-0.0007664762077025523,-1.2398620877385602
78,2001-09-07,Rock Star,38000000,16991902,19317765,-18682235,-0.009671012666320354,-1.2363594140314604
15,2018-06-08,Hotel Artemis,15000000,6708137,12758799,-2241201,-0.0017565924504336183,-1.2360902885555258
77,2011-10-14,The Thing,38000000,16999934,27573078,-10426922,-0.003781558953991281,-1.2353027958814429
77,2009-06-05,Away We Go,21000000,9451946,10108016,-10891984,-0.010775590382919854,-1.2217647032685122
82,2005-06-03,The Lords of Dogtown,25000000,11273517,13424365,-11575635,-0.008622854786799973,-1.2175865792369853
87,2001-04-27,Driven,72000000,32616869,54616869,-17383131,-0.0031827402995217467,-1.2074467049550341
37,2004-04-02,Home on the Range,110000000,50026353,76482461,-33517539,-0.004382382386989352,-1.1988410788209967
50,2004-08-27,Superbabies: Baby Geniuses 2,20000000,9109322,9355369,-10644631,-0.011378098501512874,-1.1955530828748835
81,2002-07-03,The Powerpuff Girls,25000000,11411644,16425701,-8574299,-0.005220050578054477,-1.1907448216926502
49,2009-12-04,Everybody's Fine,20000000,9208876,9208876,-10791124,-0.011718177115209283,-1.1718177115209283
1,2012-03-09,A Thousand Words,40000000,18450127,20790486,-19209514,-0.009239569483849488,-1.1680067568098582
80,2011-04-15,The Conspirator,25000000,11538204,15907411,-9092589,-0.005715945228296421,-1.166715027746086
15,2006-11-17,For Your Consideration,12000000,5549923,5549923,-6450077,-0.011621921601434831,-1.162192160143483
22,2009-12-11,The Lovely Bones,95000000,44114232,94894448,-105552,-1.112309542071418e-05,-1.153500031463769
24,2006-12-25,Children of Men,76000000,35552383,69845011,-6154989,-0.0008812353111376846,-1.1376907421367508
6,2015-12-30,Anomalisa,8000000,3759286,5706168,-2293832,-0.004019916693655006,-1.1280636801775656
35,2005-12-02,Aeon Flux,55000000,25857987,53913573,-1086427,-0.00020151270627157285,-1.1270023842149817
18,2002-02-08,Collateral Damage,85000000,40048332,78353508,-6646492,-0.0008482698694230767,-1.1224354612321932
64,2007-04-06,Grindhouse,53000000,25031037,50187789,-2812211,-0.0005603376948922776,-1.1173713258463882
14,2012-06-01,For Greater Glory: The True Story of Cristiada,12000000,5669081,10026255,-1973745,-0.001968576502392967,-1.1167452008535421
3,2005-04-08,Sahara,145000000,68671925,121671925,-23328075,-0.0019172931635625884,-1.111488792545134
70,2003-06-20,Alex & Emma,30000000,14208384,15358583,-14641417,-0.00953305197491201,-1.1114294208264641
48,2017-10-27,Thank You for Your Service,20000000,9479390,9985316,-10014684,-0.01002941118738756,-1.109840401122857
47,2016-06-03,Popstar: Never Stop Never Stopping,20000000,9496130,9537120,-10462880,-0.010970691361752813,-1.1061211251320275
29,2005-05-27,Saving Face,2500000,1187266,1269705,-1230295,-0.009689612941588795,-1.105678087303098
8,2005-06-10,The Honeymooners,27000000,12834849,13174426,-13825574,-0.01049425151425952,-1.1036476549120289
29,2007-10-12,Lars and the Real Girl,12500000,5956480,11277119,-1222881,-0.0010843913237059927,-1.0985548511872785
46,2007-08-31,Death Sentence,20000000,9534258,16907831,-3092169,-0.001828838364897307,-1.0976986358036462
69,2004-04-30,Godsend,30000000,14334645,16910708,-13089292,-0.007740238906614672,-1.092831737374731
33,2002-11-01,I Spy,70000000,33561137,60279822,-9720178,-0.001612509406547352,-1.0857457838809215
75,2004-12-10,The Life Aquatic with Steve Zissou,50000000,24006726,34806726,-15193274,-0.004365039676526888,-1.0827496427459538
97,2004-06-11,The Chronicles of Riddick,120000000,57712751,107212751,-12787249,-0.0011926985251968772,-1.0792632116947605
75,2017-10-20,Only the Brave,38000000,18340051,24555177,-13444823,-0.00547535169467522,-1.0719680659557598
93,2003-12-25,Peter Pan,100000000,48417850,95255485,-4744515,-0.0004980831287563125,-1.065353996511617
5,2016-09-02,Morgan,8000000,3915251,7298786,-701214,-0.0009607268934861223,-1.0432917327650257
92,2009-06-05,Land of the Lost,100000000,49438370,69548641,-30451359,-0.0043784261722669745,-1.0227204092691566
75,2004-11-12,After the Sunset,57000000,28328132,38329114,-18670886,-0.004871202084138966,-1.0121340863562764
54,2005-10-14,Elizabethtown,54000000,26850426,50719373,-3280627,-0.000646819313006886,-1.0111412757473568
68,2005-08-26,The Cave,30000000,15007991,27147991,-2852009,-0.0010505414562720313,-0.9989351006407187
91,2008-08-22,The Longshots,23000000,11511323,11778396,-11221604,-0.009527276888975374,-0.9980327196100743
28,2002-02-22,Dragonfly,60000000,30063805,30063805,-29936195,-0.009957553609731036,-0.9957553609731037
46,2001-09-21,Glitter,8500000,4273372,4273372,-4226628,-0.009890615654335733,-0.9890615654335733
74,2004-02-27,Twisted,50000000,25195050,40119848,-9880152,-0.0024626593799657467,-0.9845167999269698
99,2012-02-03,Big Miracle,40000000,20157300,25268680,-14731320,-0.0058298731868859,-0.9843927510132805
76,2017-09-22,Battle of the Sexes,25000000,12638526,18445379,-6554621,-0.0035535301280608,-0.9780787727935996
13,2013-01-04,Promised Land,15000000,7597898,12394562,-2605438,-0.002102081541889096,-0.9742302410482478
65,2001-07-20,Hedwig and the Angry Inch,6000000,3067312,3740030,-2259970,-0.006042652064288254,-0.9561101055256198
91,2006-03-31,Slither,15250000,7802450,12930343,-2319657,-0.0017939640116275337,-0.9545142871790271
41,2013-12-04,Out of the Furnace,22000000,11330849,15434375,-6565625,-0.004253897550111359,-0.9416020811856199
34,2008-06-20,The Love Guru,62000000,32235793,40159017,-21840983,-0.005438624904588676,-0.9233278982775451
16,2002-09-20,The Four Feathers,35000000,18306166,29882645,-5117355,-0.0017124839518054711,-0.9119241025127818
15,2007-12-21,Walk Hard: The Dewey Cox Story,35000000,18317151,20606053,-14393947,-0.0069853003872211725,-0.9107775002782911
71,2002-08-09,Blood Work,50000000,26199517,26199517,-23800483,-0.009084321287297015,-0.9084321287297014
32,2007-09-14,The Brave One,70000000,36793804,69792704,-207296,-2.970167196846249e-05,-0.9024942351706825
90,2004-01-09,Chasing Liberty,23000000,12189514,12291975,-10708025,-0.008711395036192312,-0.8868676798763265
98,2002-09-13,Igby Goes Down,9000000,4777465,4777465,-4222535,-0.008838442563158496,-0.8838442563158495
25,2009-04-24,The Soloist,60000000,31853584,38522450,-21477550,-0.005575333344582185,-0.8836184964304173
88,2012-02-24,Wanderlust,32500000,17288155,24159934,-8340066,-0.003452023503044338,-0.8798998505045795
69,2003-03-28,Basic,50000000,26599248,42598498,-7401502,-0.001737503045295165,-0.8797523899923787
45,2001-12-25,Ali,109000000,58183966,87683966,-21316034,-0.002431007055497467,-0.8733683434367469
24,2002-12-06,Analyze That,60000000,32122249,54994757,-5005243,-0.0009101309421187187,-0.8678642332920089
17,2004-08-20,Exorcist: The Beginning,78000000,41814863,43957541,-34042459,-0.007744395665808512,-0.8653654323822608
73,2003-08-22,The Medallion,41000000,22108977,22108977,-18891023,-0.008544503438580627,-0.8544503438580627
31,2004-09-17,Sky Captain and the World of Tomorrow,70000000,37760080,49730854,-20269146,-0.004075768737050041,-0.8538096317592547
65,2008-04-04,Leatherheads,58000000,31373938,41348628,-16651372,-0.00402706759701918,-0.848668152528382
100,2007-09-14,Across the Universe,45000000,24343673,29367143,-15632857,-0.005323247481036885,-0.8485295953490667
11,2006-05-05,Hoot,15000000,8117637,8224998,-6775002,-0.00823708650141921,-0.8478283766569015
50,2011-05-13,Everything Must Go,5000000,2712131,2821010,-2178990,-0.007724148443288043,-0.8435687656680301
97,2008-08-22,Hamlet 2,9000000,4886216,4934104,-4065896,-0.008240393797941835,-0.841916116684158
40,2017-11-17,"Roman J. Israel, Esq.",22000000,11962712,12967012,-9032988,-0.006966129128283371,-0.8390478680753997
28,2010-10-15,Conviction,12500000,6797696,11826980,-673020,-0.0005690548221101246,-0.8388583425913722
65,2004-04-09,The Whole Ten Yards,30000000,16323969,26323969,-3676031,-0.001396457730215379,-0.8377883466943609
74,2011-09-09,Warrior,25000000,13657115,24215385,-784615,-0.000324015083798998,-0.830547666912082
10,2002-06-21,Sunshine State,5600000,3064356,3281898,-2318102,-0.007063296909288467,-0.8274639108510891
60,2007-07-04,Rescue Dawn,10000000,5490423,7037886,-2962114,-0.004208812134780245,-0.8213532909941548
96,2019-05-17,The Sun is Also a Star,9000000,4950029,5434029,-3565971,-0.006562296594294952,-0.818171166269935
29,2012-06-15,Rock of Ages,70000000,38518613,61031932,-8968068,-0.001469405884119808,-0.8173032346725465
14,2005-02-25,Cursed,35000000,19294901,25114901,-9885099,-0.0039359498172021464,-0.8139507427376798
65,2008-02-22,Witless Protection,7500000,4151836,4151836,-3348164,-0.008064297337370744,-0.8064297337370744
59,2001-10-12,Bandits,75000000,41523271,71523271,-3476729,-0.0004860975947254984,-0.8062160854331538
63,2014-03-14,Veronica Mars,6000000,3322127,3485383,-2514617,-0.007214750860952728,-0.8060718328950097
46,2004-02-20,Welcome to Mooseport,26000000,14469428,14469428,-11530572,-0.00796892040238218,-0.7968920402382181
10,2018-10-12,Bad Times at the El Royale,32000000,17839115,29204379,-2795621,-0.0009572608957033464,-0.7938109597925682
73,2007-08-03,Hot Rod,25000000,13938332,14334401,-10665599,-0.007440561346093219,-0.7936149031318812
9,2004-04-30,Laws of Attraction,32000000,17848322,29948322,-2051678,-0.0006850727730254803,-0.7928856281279552
9,2002-05-22,The Importance of Being Earnest,15000000,8378141,8378141,-6621859,-0.007903733059636977,-0.7903733059636977
72,2002-09-13,Stealing Harvard,25000000,13973532,13973532,-11026468,-0.007890967008198071,-0.7890967008198071
13,2003-09-26,The Rundown,85000000,47641743,80831893,-4168107,-0.0005156512912545547,-0.784149668915346
58,2004-12-17,Spanglish,75000000,42044321,54344321,-20655679,-0.0038008900690837595,-0.7838318758911578
92,2002-09-06,City by the Sea,40000000,22433915,22433915,-17566085,-0.007830146900351543,-0.7830146900351543
11,2013-01-18,Broken City,35000000,19701164,34480045,-519955,-0.0001507988171129127,-0.776544776745171
59,2015-03-20,Danny Collins,10000000,5637066,8465845,-1534155,-0.001812169960588695,-0.773972488525059
57,2006-07-21,Lady in the Water,75000000,42285169,72785169,-2214831,-0.00030429701963046894,-0.7736715206222777
64,2002-03-08,Men with Brooms,7500000,4239767,4239767,-3260233,-0.007689651341689295,-0.7689651341689295
63,2010-06-04,Splice,30000000,17010170,28542494,-1457506,-0.0005106442345227435,-0.7636508041953726
3,2015-05-29,Aloha,37000000,21052030,25387091,-11612909,-0.00457433622465843,-0.7575502219975936
12,2006-10-20,Running With Scissors,12000000,6860000,8706701,-3293299,-0.0037824877643093512,-0.749271137026239
8,2003-03-21,Boat Trip,15000000,8586376,14933713,-66287,-4.438748755918907e-05,-0.7469535459430149
9,2007-06-22,Evan Almighty,175000000,100289690,174131329,-868671,-4.988596853814859e-05,-0.7449450686306838
10,2012-08-24,Premium Rush,35000000,20275446,31393201,-3606799,-0.0011489108740456253,-0.7262258990505067
39,2004-10-01,I Heart Huckabees,22000000,12784713,20034713,-1965287,-0.0009809409298750622,-0.7208051522157752
20,2013-08-30,Getaway,18000000,10501938,11813989,-6186011,-0.005236174673939513,-0.7139693645115788
26,2002-08-23,Serving Sara,29000000,16930185,20146150,-8853850,-0.004394809926462376,-0.7129168996085985
25,2004-11-12,Seed of Chucky,29000000,17016190,24716190,-4283810,-0.0017331999794466704,-0.7042592965875439
44,2004-02-27,Club Dread,8500000,5001655,7573551,-926449,-0.001223268979109007,-0.6994374861920705
68,2010-10-08,My Soul to Take,25000000,14744435,16727470,-8272530,-0.004945475914767744,-0.695554967009587
6,2016-09-23,Queen of Katwe,15000000,8874389,10055481,-4944519,-0.004917237673662751,-0.6902572109471424
87,2004-06-11,The Stepford Wives,100000000,59475623,96221971,-3778029,-0.00039263683343173256,-0.6813611183190128
32,2018-02-23,Annihilation,55000000,32732301,43070915,-11929085,-0.002769638165337328,-0.6802973918637739
18,2012-09-21,Trouble with the Curve,60000000,35763137,47818913,-12181087,-0.002547336657359819,-0.6777051744649805
73,2001-12-21,Joe Somebody,38000000,22770864,24515990,-13484010,-0.005500087901814285,-0.6687992164021532
56,2002-05-03,Deuces Wild,10000000,6044618,6244618,-3755382,-0.0060137897946679845,-0.6543642625555495
19,2007-06-22,You Kill Me,4000000,2426851,3858964,-141036,-0.0003654763299165268,-0.6482264465350366
28,2014-09-19,Tusk,3000000,1821983,1887554,-1112446,-0.005893585031209703,-0.6465576243027514
31,2008-02-29,Semi-Pro,55000000,33479698,43980363,-11019637,-0.002505581184038886,-0.6427866225077657
57,2005-10-21,North Country,30000000,18324242,23676771,-6323229,-0.002670646685732611,-0.6371754968090904
37,2009-03-27,12 Rounds,20000000,12234694,17306648,-2693352,-0.0015562528341710074,-0.6346955632891186
65,2005-09-30,The Greatest Game Ever Played,25000000,15331289,15468266,-9531734,-0.006162121856451137,-0.63065219108452
47,2018-03-09,Thoroughbreds,5000000,3072605,3187302,-1812698,-0.005687248964798441,-0.6272836892473975
3,2003-02-21,Dark Blue,15000000,9237470,12262065,-2737935,-0.002232849850331082,-0.6238212410974
36,2002-08-23,Undisputed,20000000,12398628,12398628,-7601372,-0.006130817054919302,-0.6130817054919302
28,2003-03-14,The Hunted,55000000,34234008,47213095,-7786905,-0.0016493104296593983,-0.6065895643887212
62,2002-11-15,Half Past Dead,25000000,15567860,19233280,-5766720,-0.002998302941567949,-0.6058726119068388
35,2005-10-28,The Weather Man,20000000,12482775,15466961,-4533039,-0.0029307884076257775,-0.6022078424068367
37,2012-08-22,Hit & Run,22000000,13749300,17216955,-4783045,-0.0027781015864884358,-0.6000814586924426
2,2007-03-02,Black Snake Moan,15000000,9396870,10951153,-4048847,-0.003697187866884884,-0.5962762068646262
59,2012-01-27,One for the Money,42000000,26414527,36197221,-5802779,-0.001603100691072389,-0.5900341505263372
72,2001-05-18,Angel Eyes,38000000,24044532,29544532,-8455468,-0.002861940070670268,-0.5804008994643772
37,2001-10-19,Riding in Cars with Boys,47000000,29781453,29781453,-17218547,-0.005781634294337486,-0.5781634294337485
44,2001-08-03,Original Sin,26000000,16521410,16521410,-9478590,-0.005737155605968256,-0.5737155605968256
86,2017-06-30,The House,40000000,25584504,31192425,-8807575,-0.00282362624900116,-0.5634463736330397
24,2008-12-05,Frost/Nixon,29000000,18622031,28452945,-547055,-0.000192266565025167,-0.5572952273573167
46,2016-04-15,Green Room,5000000,3220371,3807503,-1192497,-0.0031319660155225094,-0.5526161426742446
36,2001-04-11,Josie and the Pussycats,22000000,14252830,14252830,-7747170,-0.005435531048921512,-0.5435531048921513
54,2004-01-16,Teacher's Pet: The Movie,10000000,6491969,6491969,-3508031,-0.005403647183158146,-0.5403647183158146
7,2004-04-09,Ella Enchanted,35000000,22913677,22913677,-12086323,-0.005274719984924288,-0.5274719984924288
6,2016-03-04,Whiskey Tango Foxtrot,35000000,23083334,25350747,-9649253,-0.0038062992778871564,-0.5162454435741388
98,2003-03-21,L\'auberge espagnole,5900000,3895664,3895664,-2004336,-0.005145043309689953,-0.5145043309689953
59,2006-12-08,Unaccompanied Minors,25000000,16655224,21970831,-3029169,-0.0013787229986885793,-0.501030547532714
29,2006-10-13,One Night with the King,20000000,13395961,13725032,-6274968,-0.004571915023586102,-0.49298732655313043
2,2006-12-22,We Are Marshall,65000000,43545364,43545364,-21454636,-0.004926962144580994,-0.49269621445809936
4,2001-11-09,Heist,35000000,23483357,28906817,-6093183,-0.0021078706105898824,-0.4904172346398345
10,2012-10-26,Fun Size,14000000,9409538,11166615,-2833385,-0.0025373714415693567,-0.4878520071867503
34,2001-12-14,The Other Side of Heaven,7000000,4720371,4720371,-2279629,-0.004829342863092753,-0.48293428630927526
83,2001-09-07,The Musketeer,40000000,27053815,27053815,-12946185,-0.004785345430949387,-0.47853454309493876
28,2004-04-30,Envy,20000000,13548322,14566246,-5433754,-0.0037303736323003197,-0.4761975689683195
51,2004-08-06,Little Black Book,30000000,20422207,21758371,-8241629,-0.003787796889757969,-0.4689891254162687
52,2012-11-30,The Collection,10000000,6810754,8890094,-1109906,-0.0012484749880035016,-0.4682662154586702
8,2008-12-05,Cadillac Records,12000000,8195551,8942516,-3057484,-0.0034190422471707064,-0.4642090568407176
51,2011-02-11,Cedar Rapids,10000000,6861102,7862131,-2137869,-0.002719197886679833,-0.45749181399722666
80,2006-11-22,Deck the Halls,51000000,35093569,46815807,-4184193,-0.0008937564613593011,-0.4532577179596638
1,2012-11-21,Red Dawn,65000000,44806783,48164150,-16835850,-0.003495514817556212,-0.45067321615122424
99,2004-10-08,Raise Your Voice,15000000,10411980,14811980,-188020,-0.00012693778954602964,-0.4406481764275383
50,2018-01-12,Proud Mary,30000000,20868638,21709539,-8290461,-0.0038188102474216523,-0.43756386976476375
57,2008-04-04,The Ruins,25000000,17432844,22910563,-2089437,-0.0009119972302732152,-0.4340746696293502
56,2017-12-22,Father Figures,25000000,17501244,21038441,-3961559,-0.0018830097724446407,-0.4284698847693341
85,2004-09-01,Vanity Fair,23000000,16123851,19123851,-3876149,-0.0020268663461140753,-0.42645823258972065
7,2013-03-15,The Incredible Burt Wonderstone,32000000,22537881,27392609,-4607391,-0.0016819832678223532,-0.419831793414829
55,2004-01-23,Win a Date with Tad Hamilton!,24000000,16980098,16980098,-7019902,-0.004134194042931908,-0.4134194042931908
55,2004-02-20,Eurotrip,25000000,17718223,20718223,-4281777,-0.0020666719341711883,-0.4109767102491034
54,2002-10-11,Punch-Drunk Love,25000000,17791031,24591031,-408969,-0.00016630819586214177,-0.4052024303706738
59,2009-07-29,Adam,3200000,2283291,2834485,-365515,-0.0012895287856524201,-0.4014858377666272
82,2009-07-31,Funny People,72500000,51855045,71880305,-619695,-8.621207158205576e-05,-0.3981281859846038
36,2007-07-27,No End In Sight,2000000,1433319,1433319,-566681,-0.003953627908372107,-0.3953627908372107
21,2009-09-23,Capitalism: A Love Story,20000000,14363397,19121531,-878469,-0.0004594135270862987,-0.39242826749131837
25,2007-09-21,Sydney White,16500000,11892415,13636339,-2863661,-0.0021000218607061614,-0.38743896845174003
62,2004-09-03,The Cookout,16000000,11540112,11540112,-4459888,-0.0038646834623442122,-0.3864683462344213
7,2009-06-19,Year One,60000000,43337279,57604723,-2395277,-0.0004158126061989743,-0.38448932153769966
45,2017-03-03,Table 19,5000000,3614896,4620399,-379601,-0.0008215762318362549,-0.38316565677131514
48,2004-09-17,Mr. 3000,30000000,21800302,21827296,-8172704,-0.0037442585650554246,-0.37612772520307286
79,2005-11-23,Rent,40000000,29077547,31670620,-8329380,-0.00263000219130538,-0.37563185780423636
58,2018-12-25,Holmes & Watson,42000000,30568743,41926605,-73395,-1.7505591020307987e-05,-0.37395247164726403
47,2001-10-24,Bones,10000000,7316658,8378853,-1621147,-0.0019348077833565046,-0.3667442157334674
9,2001-02-02,Head Over Heels,14000000,10397365,10397365,-3602635,-0.003464950013777529,-0.3464950013777529
19,2014-01-31,Labor Day,18000000,13371528,14189810,-3810190,-0.0026851592797930346,-0.346143836366345
53,2017-03-24,CHiPS,25000000,18600152,23190292,-1809708,-0.0007803730975013165,-0.34407503766635883
7,2003-07-11,Northfork,1900000,1420578,1445140,-454860,-0.003147515119642388,-0.33748375661174534
55,2004-05-28,Raising Helen,50000000,37485528,49928680,-71320,-1.4284375232832112e-05,-0.33384809198899373
27,2003-04-04,DysFunkTional Family,3000000,2255000,2255000,-745000,-0.003303769401330377,-0.3303769401330377
52,2011-09-02,Shark Night 3D,25000000,18877153,18877153,-6122847,-0.0032435224739662803,-0.3243522473966281
96,2002-11-27,Wes Craven Presents: They,17000000,12840842,16140842,-859158,-0.0005322882164387707,-0.32390072239811063
17,2004-07-16,Camping Sauvage,4600000,3479302,3479302,-1120698,-0.0032210426114203366,-0.32210426114203367
59,2009-03-13,Miss March,6000000,4543320,4713059,-1286941,-0.002730585379898703,-0.32062016322865217
82,2009-10-16,Where the Wild Things Are,100000000,77233467,99123656,-876344,-8.840916844310102e-05,-0.2947754889729345
76,2008-08-01,Swing Vote,21000000,16289867,17589867,-3410133,-0.0019386917479250981,-0.2891449635531094
60,2012-06-29,People Like Us,16000000,12431792,12617472,-3382528,-0.002680828616065088,-0.287022820201625
17,2003-01-17,A Guy Thing,20000000,15543862,17430594,-2569406,-0.0014740782786863145,-0.28668152097593247
93,2002-10-11,Knockaround Guys,15000000,11660180,12419700,-2580300,-0.0020775864151308,-0.2864295405388253
44,2014-03-14,Bad Words,10000000,7779614,7843145,-2156855,-0.0027499874093874334,-0.28541081858302997
32,2001-09-28,Hearts in Atlantis,31000000,24185781,30885781,-114219,-3.698109495757935e-05,-0.28174484007773
16,2004-09-03,Paparazzi,20000000,15712072,16612072,-3387928,-0.002039437344119385,-0.27290659055024696
24,2003-12-19,House of Sand and Fog,16500000,13005485,16157923,-342077,-0.00021170852219063057,-0.26869547733129523
1,2010-10-08,It's Kind of a Funny Story,8000000,6363628,6632950,-1367050,-0.002060998499913312,-0.2571445093899266
42,2018-09-14,White Boy Rick,30000000,24004833,25947983,-4052017,-0.0015615922825292434,-0.24974833192965767
27,2003-10-03,Sur Le Seuil,2500000,2013052,2013052,-486948,-0.0024189539068041957,-0.24189539068041957
31,2007-07-27,Who's Your Caddy?,7000000,5694308,5694308,-1305692,-0.0022929774785628034,-0.22929774785628035
92,2003-04-25,Confidence,15000000,12212417,12212417,-2787583,-0.002282580917438374,-0.22825809174383743
42,2008-08-06,Bottle Shock,5000000,4078607,4815890,-184110,-0.0003822969378453411,-0.2259087477660878
15,2009-07-10,"I Love You, Beth Cooper",18000000,14800725,16382538,-1617462,-0.0009873085598824797,-0.21615664097535764
80,2004-04-02,Walking Tall,56000000,46213824,47313824,-8686176,-0.0018358642920090333,-0.21175862876008703
33,2003-09-12,"The Book of Mormon Movie, Volume 1: The Journey",2000000,1660865,1660865,-339135,-0.002041917916266524,-0.20419179162665238
98,2013-05-10,Peeples,11000000,9177065,9307166,-1692834,-0.0018188501204340825,-0.19864030602376687
7,2017-10-13,Marshall,12000000,10051659,10116816,-1883184,-0.0018614394093952088,-0.19383277924569467
14,2014-07-25,And So It Goes,18000000,15160801,17920013,-79987,-4.4635570297856366e-05,-0.18727236113711934
91,2006-08-25,Idlewild,15000000,12669914,12669914,-2330086,-0.0018390700994497674,-0.18390700994497675
84,2007-02-23,The Astronaut Farmer,13000000,11003643,11141213,-1858787,-0.0016683883523275248,-0.18142691470452105
10,2002-07-26,The Country Bears,20000000,16988996,16988996,-3011004,-0.0017723260397494943,-0.17723260397494944
42,2010-05-21,MacGruber,10000000,8525600,8629895,-1370105,-0.0015876265006700546,-0.1729379750398799
92,2006-01-13,Last Holiday,45000000,38399961,43343247,-1656753,-0.0003822401676551828,-0.17187619018675565
61,2012-01-20,Red Tails,58000000,49876377,50365498,-7634502,-0.001515819817764931,-0.1628751623238392
8,2009-02-20,Fired Up,20000000,17231291,18608570,-1391430,-0.0007477361237322373,-0.16067913889911092
87,2008-01-11,The Pirates Who Don't Do Anything: A VeggieTales Movie,15000000,12981269,13248444,-1751556,-0.0013220843142032377,-0.15551106752352178
92,2002-02-22,Queen of the Damned,35000000,30307804,30307804,-4692196,-0.0015481807919834772,-0.15481807919834772
40,2006-05-12,Keeping Up with the Steins,5000000,4339241,4414753,-585247,-0.001325661933974562,-0.1522752481367133
84,2002-06-21,Juwanna Mann,15600000,13571817,13771817,-1828183,-0.001327481333799309,-0.14944078600529317
58,2004-05-28,Soul Plane,16000000,13922211,14553807,-1446193,-0.0009936870813251817,-0.14924274599774418
41,2003-06-13,Dumb and Dumberer: When Harry Met Lloyd,30000000,26214846,26214846,-3785154,-0.001443897095561805,-0.1443897095561805
7,2015-02-20,Hot Tub Time Machine 2,14000000,12314651,12826644,-1173356,-0.0009147802028340383,-0.1368572280286303
56,2003-07-18,How to Deal,16000000,14108518,14108518,-1891482,-0.0013406666809370055,-0.13406666809370055
4,2006-09-29,School for Scoundrels,20000000,17807569,17807569,-2192431,-0.0012311792811247847,-0.12311792811247846
6,2007-03-16,I Think I Love My Wife,14000000,12559771,13205411,-794589,-0.0006017147061912727,-0.11467000473177417
95,2006-03-24,Larry the Cable Guy: Health Inspector,17000000,15680099,15680099,-1319901,-0.0008417682822028101,-0.08417682822028101
10,2004-02-06,Catch That Kid,18000000,16703799,16959614,-1040386,-0.0006134491032637889,-0.07759917369695361
38,2004-04-02,The Prince & Me,30000000,28165882,29356757,-643243,-0.00021911241762841857,-0.06511842945305246
85,2005-07-22,The Bad News Bears,35000000,32868349,33500620,-1499380,-0.00044756783605795947,-0.06485421582933783
38,2004-07-09,Sleepover,10000000,9408183,9408183,-591817,-0.0006290449494870582,-0.06290449494870583
12,2001-06-29,Pootie Tang,3500000,3293258,3293258,-206742,-0.0006277734693121523,-0.06277734693121523
96,2003-03-07,Nowhere in Africa,6500000,6173485,6173485,-326515,-0.0005288989930322987,-0.05288989930322986
83,2001-04-20,Freddy Got Fingered,15000000,14249005,14249005,-750995,-0.000527050836181193,-0.0527050836181193
14,2003-04-25,The Real Cancun,4000000,3816594,3816594,-183406,-0.000480548887306326,-0.0480548887306326
84,2001-11-21,Black Knight,35000000,33422806,33422806,-1577194,-0.0004718915581175321,-0.04718915581175321
81,2001-10-05,Joy Ride,23000000,21973182,21973182,-1026818,-0.0004673050994616983,-0.04673050994616983
38,2015-09-11,90 Minutes in Heaven,5000000,4816142,4816142,-183858,-0.00038175369413941704,-0.0381753694139417
95,2017-10-20,Same Kind of Different as Me,6500000,6423605,6423605,-76395,-0.00011892854557526499,-0.011892854557526499
31,2006-10-04,Shortbus,2000000,1985292,1985292,-14708,-7.408481976454848e-05,-0.007408481976454849
